border_size=1
usage=map

Gg, Gg, Gg, Gg, Gg, Gg, Xu, Xu, Xu, Xu, Xu, Xu, Xu, Xu, Xu, Xu, Xu, Xu, Xu, Xu, Xu, Xu, Xu, Xu, Xu, Xu, Xu, Xu, Xu, Xu, Xu, Xu, Xu, Xu, Xu, Xu, Xu, Xu, Xu, Xu, Xu, Xu
Gg, Gg, Gg^Vh, Gg, Gg, Gg, Xu, Xu, Uu, Xu, Chr, Xu, Uu, Xu, Xu, Xu, Xu, Xu, Xu, Xu, Xu, Xu, Xu, Xu, Xu, Xu, Xu, Xu, Xu, Xu, Xu, Xu, Xu, Xu, Xu, Xu, Xu, Xu, Xu, Xu, Xu, Xu
Gg^Br\, Gg, Gg, Gg, Xu, Xu, Uu, Uu, Re, Chr, 2 Kh, Chr, Uu, Xu, Xu, Xu, Uh, Uu^Vu, Uu, Uu, Uu, Uu, Chr, Uu, Uh, Uu^Uf, Rd, Uu^Vu, Uu^Uf, Xu, Uu^Vu, Uu^Vu, Uu, Chr, Uu, Xu, Xu, Uu^Vu, Uu, Xu, Xu, Xu
Gg, Gg^Br\, Uu^Br\, Xu, Uu, Uu, Rd, Uu, Rd, Chr, Chr, Chr, Xu, Rd, Xu, Xu, Uu^Vu, Uh, Chr, Uu, Uu, Chr, 8 Kh, Chr, Uu, Uu, Uu, Uu^Uf, Re, Uu, Uu, Rd, Re, Uu, Uu^Vu, Chr, Uu, Uu, Uu^Vu, Uu^Uf, Xu, Xu
Xu, Xu, Uu^Br|, Uu^Uf, Re, Re, Xu, Uu, Uu, Uu, Xu, Uu, Uu^Vu, Xu, Uu^Uf, Rd, Uu, Uu, Uu, Re, Uu, Chr, Chr, Chr, Uu, Uu, Xu, Re, Uu^Uf, Uu, Chr, Re, Xu, Uu, Uu, Uu, Chr, Xu, Xu, Uu^Vu, Xu, Xu
Xu, Xu, Uu^Vu, Uu^Br\, Xu, Xu, Uu, Uu^Vu, Uu, Xu, Rd, Xu, Xu, Xu, Uu^Vu, Re, Uu, Uu^Vu, Uu, Re, Rd, Uu, Uu, Uu, Uu, Uu, Uu^Uf, Xu, Re, Rd, Xu, Xu, Uu^Uf, Uu^Uf, Uu, Uu^Vu, Uu, Xu, Xu, Xu, Xu, Xu
Xu, Xu, Rd, Re^Br|, Xu, Xu, Rd, Re, Re, Uu, Uu, Uu^Vu, Xu, Xu, Xu, Uu^Uf, Chr, Uu, Uu, Uh, Uu, Uu^Uf, Uu^Uf, Uu, Rd, Uu, Uu^Vu, Xu, Uu, Uh, Xu, Uu^Vu, Re, Chr, Xu, Re, Xu, Uu, Xu, Uu^Uf, Uh, Uh
Xu, Xu, Rd, Uu^Br|, Xu, Xu, Xu, Chr, Rd, Uu, Re, Rd, Uu, Xu, Xu, Xu, Xu, Uu^Vu, Xu, Xu, Uu, Xu, Xu, Xu, Xu, Xu, Xu, Xu, Uu, Uu, Xu, Uu^Uf, Xu, Xu, Uu^Uf, Xu, Chr, Xu, Uu, Uu^Vu, Xu, Xu
Xu, Xu, Chr, Uu^Br|, Uu^Uf, Xu, Xu, Uu, Re, Uu^Vu, Rd, Uu, Uu, Uu^Vu, Uu, Xu, Xu, Xu, Uu, Chr, Rd, Uu^Vu, Uu, Uh, Uh, Uu^Vu, Uu, Uu^Uf, Rd, Uh, Uh, Xu, Kud, Uu^Vu, Uu, Uu^Vu, Rd, Uu^Vu, Uu^Vu, Uu, Uu^Vu, Uu
Xu, Xu, Chr, Uu^Br|, Uu, Xu, Xu, Xu, Xu, Re, Re, Rd, Rd, Chr, Uu, Xu, Xu, Uu^Vu, Uu, Uu^Uf, Rd, Uu, Uu, Uu, Uu, Uu, Chr, Uu, Re, Uu, Uu, Xu, Uu^Vu, Uh, Rd, Re, Re, Uu, Uu, Re, Xu, Xu
Xu, Xu, Uu^Vu, Uu^Br\, Rd^Br\, Re, Xu, Xu, Xu, Xu, Xu, Xu, Xu, Xu, Xu, Xu, Xu, Uu, Uu, Uh, Uu, Uu^Uf, Uu, Uu, Uu, Uu, Uu, Uu, Rd, Chr, Uu^Uf, Xu, Xu, Uu, Uu^Vu, Uu, Uu^Vu, Chr, Uu^Vu, Uu^Uf, Xu, Xu
Xu, Xu, Xu, Uu, Uu, Uu^Br\, Uu^Br\, Uu^Vu, Uu, Xu, Xu, Xu, Xu, Xu, Xu, Xu, Xu, Chr, Uu, Uu, Uu, Uu^Vu, Chr, Kh, Re, Uu, Re, Uu, Uu, Uu^Uf, Uu^Vu, Xu, Uu^Vu, Chr, Uu, Uu, Xu, Uu^Uf, Xu, Uu^Vu, Xu, Xu
Uu^Ii, Uu^Ii, Uu^Ii, Xu, Xu, Uu, Ce, Ce, Ce, Uu, Uu^Uf, Uu, Re, Re, Uu^Uf, Uh, Rd, Uu, Rd, Uu, Chr, Re, Re, Rd, Re, Chr, Chr, Uu, Uu, Uu, Uu, Uu, Uu, Rd, Uu, Xu, Chr, Xu, Chr, Xu, Chr, Chr
Uu^Ii, Uu^Ii, Re, Uu^Vu, Uu, Uu, Ce, Ce, 1 Ke, Ce, Rd^Br\, Uu, Re^Br/, Uu, Uu^Vu, Uu^Uf, Re, Re, Rd, Uu, Uh, Uh, Re^Br\, Chr, Chr, Uu^Uf, Uu^Uf, Uu, Rd^Br/, Uu, Rd, Uu, Chr, Chr, Chr, Uu, Re, Uu, Re^Br\, Uh, Re^Br\, Re
Uu^Ii, Uu^Ii, Re, Uu^Uf, Uu, Uu, Uu, Ce, Ce, Ce, Uu, Re^Br/, Uu^Vu, Rd^Br\, Rd^Br\, Re^Br/, Rd^Br\, Uu, Uu, Re, Re^Br/, Rd^Br/, Chr, Kh, Re^Br\, Re, Re^Br/, Rd^Br/, Rd, Re^Br\, Uh^Br\, Uu, Chr, 6 Kh, Chr, Re, Re^Br/, Rd^Br/, Uh, Rd^Br/, Re, Re^Br/
Uu^Ii, Uu^Ii, Re, Re, Uu^Uf, Uu, Uu, Rd, Uu, Uu, Uh, Re, Re, Uh, Uu^Vu, Uu^Uf, Uu, Re^Br\, Rd^Br\, Rd^Br/, Re, Rd, Re, Chr, Uu, Rd^Br/, Chr, Re, Uu, Uh, Uu, Uu^Br\, Re^Br\, Chr, Uu^Br/, Uu^Br/, Chr, Uu, Chr, Uh, Chr, Chr
Re, Re, Re, Uu^Vu, Xu, Xu, Rd, Re, Xu, Uu, Chr, Uh, Xu, Xu, Xu, Chr, Xu, Uu, Uu^Uf, Uu^Uf, Uu, Chr, Chr, Uu, Chr, Re, Uu^Vu, Uu, Uu, Uu, Chr, Uu, Uu, Rd^Br\, Uu^Br\, Uu^Vu, Xu, Xu, Xu, Xu, Xu, Xu
Uh^Ii, Uh^Ii, Xu, Xu, Uu, Uu, Uu, Chr, Xu, Xu, Xu, Xu, Ww, Uh, Uh, Xu, Xu, Uu, Uu, Uu, Uu, Rd, Uu, Kh, Uu, Uu, Uu, Uu, Uu^Uf, Uu, Uu, Xu, Uu^Vu, Re, Uu, Re^Br\, Xu, Xu, Xu, Xu, Xu, Xu
Xu, Xu, Chr, Uu, Uu, Uu^Vu, Xu, Xu, Uu^Uf, Xu, Ww, Ww, Ww, Uu^Uf, Rd, Uu, Xu, Uu^Vu, Re, Uh, Uh, Uu, Uu, Uu, Uh, Uu, Uu, Uu, Uu, Uu, Uu, Xu, Xu, Rd, Rd, Rd^Br|, Re, Xu, Xu, Xu, Xu, Xu
Xu, Xu, Uu, Rd, Uh, Xu, Uu^Vu, Uu^Uf, Uu, Xu, Ww, Ww, Chr, Uu, Uu^Vu, Uu, Xu, Re, Re, Rd, Uu, Re, Uu, Uu, Uu, Re, Uu^Uf, Uu, Re, Uu, Re, Xu, Uu^Vu, Xu, Xu, Uu^Vu, Re^Br\, Uu^Vu, Re, Xu, Xu, Xu
Xu, Xu, Uu, Rd, Re, Xu, Uu^Uf, Re, Uu^Uf, Xu, Ww, Uu^Vu, Re, Uu^Uf, Re, Uu, Xu, Uh, Rd, Uu, Xu, Re, Xu, Uu^Vu, Xu, Uu^Uf, Xu, Uu^Vu, Xu, Re, Xu, Xu, Rd, Cud, Cud, Xu, Xu, Re^Br\, Rd^Br\, Re, Uu, Uu
Xu, Xu, Uu^Vu, Uh, Uu^Uf, Xu, Uu^Vu, Re, Uu^Uf, Xu, Uu^Uf, Ww, Ww, Uu^Uf, Uu, Uu^Uf, Xu, Xu, Re, Uu^Uf, Xu, Xu, Uu^Vu, Xu, Uu^Vu, Xu, Xu, Xu, Cud, Xu, Xu, Cud, Rd, Cud, Cud, Cud, Xu, Chr, Rd^Br|, Uu, Re, Re
Xu, Xu, Uu^Uf, Re, Uu, Xu, Uh, Re, Uu^Vu, Xu, Uu^Vu, Uu^Uf, Uu^Vu, Ww, Ww, Uu^Vu, Xu, Chr, Uu, Uu^Uf, Xu, Re^Gvs, Re^Gvs, Uu^Ii, Uu^Ii, Re^Gvs, Xu, Xu, Rd, Rd, Rd, Rd, Cud, Rd, Rd, 4 Kud, Cud, Xu, Re^Br|, Re, Uu, Uu
Xu, Xu, Uu, Re, Chr, Xu, Uu, Re, Xu, Xu, Re, Uu, Ww, Ww, Chr, Ww, Xu, Chr, Rd, Re, Xu, Uu^Vu, Uu^Ii, Uu^Ii, Re^Gvs, Uu^Vu, Rd, Uu^Ii, Re, Xu, Xu, Cud, Kud, Rd, Rd, Cud, Cud, Xu, Uu^Br|, Chr, Rd, Rd
Xu, Xu, Uh, Uu, Chr, Xu, Uu^Vu, Rd, Xu, Re, Ww, Ww, Re, Uu^Uf, Uu^Uf, Uu^Vu, Xu, Rd, Uu, Uu, Xu, Re^Gvs, Uu^Vu, Re^Gvs, Uu^Vu, Uu^Ii, Chr, Xu, Xu, Re, Re, Xu, Xu, Uu, Uu^Vu, Rd, Rd, Xu, Re^Br|, Re, Rd, Rd
Xu, Xu, Uh, Rd, Xu, Xu, Re, Rd, Xu, Ww, Uu^Vu, Uu^Uf, Uu^Uf, Rd, Uu, Xu, Uu, Re, Uu, Chr, Chr, Xu, Xu, Chr, Re^Gvs, Uu^Vu, Re^Gvs, Uu^Vu, Xu, Rd, Cud, Xu, Uu^Vu, Uu, Uu^Uf, Uu, Uu^Vu, Xu, Uu^Br|, Rd, Uu^Uf, Uu^Uf
Xu, Xu, Uu, Re, Xu, Xu, Uu, Uu^Vu, Xu, Ww, Ww, Uu^Uf, Re, Uu^Vu, Uu, Uu, Uh, Re, Rd, Uu^Uf, Uu^Uf, Uu^Vu, Re, Xu, Uu^Vu, Uu^Ii, Xu, Xu, Uu, Re, Uu, Xu, Uu^Vu, Uu^Uf, Xu, Uu^Vu, Xu, Xu, Re^Br|, Re, Uu^Uf, Uu^Uf
Xu, Xu, Uu, Rd, Chr, Uu, Uu^Vu, Xu, Ww, Ww, Ww, Uu^Vu, Re, Rd, Re, Uh, Uu, Uu, Chr, Uu, Uu, Uu, Uu, Xu, Xu, Xu, Uu, Uu, Re, Rd, Xu, Xu, Xu, Xu, Re, Xu, Re^Br/, Re^Br/, Uh, Uu, Uu^Uf, Uu^Uf
Xu, Xu, Uu, Chr, 3 Kh, Chr, Uu, Xu, Uu^Vu, Ww, Chr, Ww, Ww, Uu, Uu, Uu, Uu, Chr, 7 Kh, Chr, Uu, Uh, Uu, Uu, Xu, Chr, Rd, Rd, Uu, Xu, Re, Uu^Vu, Rd, Uu^Vu, Chr, Chr, Chr, Uu, Uu^Vu, Re, Chr, Chr
Xu, Xu, Xu, Chr, Chr, Chr, Uu, Xu, Ww, Ww, Uu^Uf, Uu^Uf, Ww, Uu^Vu, Uu^Uf, Uu, Uu^Uf, Chr, Chr, Chr, Uu, Uh, Re, Chr, Uu^Uf, Xu, Uu^Vu, Rd, Re, Rd, Rd, Re, Xu, Rd, Chr, 5 Kh, Chr, Rd, Re, Rd, Uu, Uu
Xu, Xu, Xu, Xu, Xu, Xu, Xu, Xu, Ww, Xu, Xu, Xu, Ww, Uu^Uf, Ww, Xu, Xu, Uu, Xu, Uu^Vu, Xu, Uu^Uf, Xu, Uu^Vu, Xu, Xu, Xu, Xu, Xu, Chr, Xu, Uu, Xu, Uu^Vu, Xu, Chr, Xu, Uu^Vu, Xu, Uh, Xu, Xu
Xu, Xu, Xu, Xu, Xu, Xu, Xu, Xu, Ww, Xu, Xu, Xu, Ww, Uu^Uf, Ww, Xu, Xu, Xu, Xu, Xu, Xu, Uu^Uf, Xu, Xu, Xu, Xu, Xu, Xu, Xu, Xu, Xu, Xu, Xu, Xu, Xu, Xu, Xu, Xu, Xu, Xu, Xu, Xu
