border_size=1
usage=map

Mm, Mm, Mm, Mm, Mm, Mm, Mm, Mm, Mm, Mm, Hh, Hh, Mm^Xm, Mm^Xm, Mm^Xm, Mm, Gs^Fp, Gg, Mm, Mm^Xm, Mm^Xm, Mm^Xm
Mm, Mm, Mm, Mm, Mm, Mm, Mm, Mm, Mm, Mm, Hh^Vc, Hh, Hh, Mm^Xm, Mm^Xm, Mm^Xm, Gs^Fp, Gg^Ve, Mm, Mm^Xm, Mm^Xm, Mm^Xm
Mm, Mm, Ce, Ce, Ce, Mm, Gg^Fet, Hh, Mm, Mm, Mm, Gs^Fp, Gs^Fp, Mm^Xm, Hh, Gs^Fp, Gs^Fp, Mm, Mm, Mm, Mm^Xm, Mm^Xm
Mm, Mm, Ce, 2 Ke, Ce, Gs^Fp, Gs^Fp, Hh, Gs^Fp, Mm, Gg, Gs^Fp, Mm^Xm, Mm^Xm, Gg^Vc, Hh, Chr, Chr, Mm, Mm, Hh^Vc, Hh
Mm, Mm, Mm, Ce, Gg, Gg, Gg, Gs^Fp, Gg^Vc, Gg, Gg, Mm^Xm, Mm^Xm, Gg, Gg, Gg, Gg, Gg, Gg, Chr, Mm, Mm
Chr, Chr, Chr, Gg, Gg, Gg, Gg, Gg, Gg, Gg, Hh, Mm, Mm^Xm, Mm, Gg, Gg, Gg, Gg, Gg, Chr, Hh, Hh
Hh, Hh^Vc, Gg, Gg, Gg, Gg, Gg, Gg, Gg, Gg, Gg, Mm, Mm^Xm, Hh, Gg^Efm, Gg^Efm, Gg^Efm, Gg^Efm, Gs^Fp, Hh, Gg^Fet, Gs^Fp
Gs^Fp, Gs^Fp, Gs^Fp, Gg, Gs^Fp, Gg, Gg, Gg, Gg, Gg, Chr, Mm^Xm, Hh, Ss, Ss, Gg^Efm, Gg^Efm, Gg^Efm, Gs^Fp, Gs^Fp, Hh, Hh
Hh, Hh, Hh, Gg^Vc, Gs^Fp, Gg, Gg, Gg, Gg, Chr, Gs^Fp, Mm^Xm, Ss, Ss, Ss, Gg, Gg, Gs^Fp, Hh, Hh, Hh^Vc, Hh
Mm, Mm, Mm, Mm, Mm, Gs^Fp, Gg, Gg, Gg^Efm, Gg^Efm, Gg^Vc, Gs^Fp, Gs^Fp, Ss, Ss, Ss, Gg, Hh, Mm, Mm, Mm, Mm
Mm, Mm, Mm, Mm, Mm, Mm, Gg, Gg, Gg^Efm, Gg^Efm, Gs^Fp, Gs^Fp, Gs^Fp, Ss, Gg, Gg, Gg, Hh, Mm, Mm, Mm, Mm
Mm, Mm, Mm, Mm, Hh, Gg^Vc, Gg, Gg^Efm, Hh, Hh, Mm, Gs^Fp, Gs^Fp, Gg, Gg, Gg, Mm, Mm, Mm, Mm, Mm, Mm
Mm, Mm, Mm, Hh, Hh, Gg, Gg, Hh, Hh, Mm, Mm, Mm, Mm, Gg^Vc, Gg, Gg, Hh, Mm, Gs^Fp, Gs^Fp, Hh^Vc, Hh
Mm, Mm, Hh, Hh, Gg, Gg, Gg^Efm, Mm, Hh, Mm, Mm, Mm, Mm, Mm, Gg, Gg, Gg, Hh, Gs^Fp, Hh, Hh, Hh
Hh, Hh, Hh, Hh, Gg, Gg, Gg^Efm, Mm, Mm, Hh, Mm, Mm, Mm, Gs^Fp, Gg, Gg, Gg, Gg, Gs^Fp, Hh, Hh, Hh
Hh, Hh, Gs^Fp, Gg^Vh, Gg, Gg, Gg^Efm, Gg^Vh, Chr, Mm, Mm, Mm, Gs^Fp, Gs^Fp, Gg, Gg, Gg, Gg, Gg^Efm, Hh, Chr, Chr
Hh, Hh, Gg^Ve, Gs^Fp, Gg, Gg, Gg^Efm, Gg^Efm, Chr, Chr, Mm, Mm, Gs^Fp, Gg^Vh, Gg, Gg, Gs^Fp, Gg, Gg, Gg^Efm, Gg^Efm, Gg^Efm
Gs^Fp, Gs^Fp, Gs^Fp, Gs^Fp, Gg, Gg, Gg, Gg, Mm, Hh, Mm, Gg^Fet, Gg, Gg, Gg, Gg, Gs^Fp, Gs^Fp, Gg^Ve, Gg^Efm, Gg^Efm, Gg^Efm
Hh, Hh, Mm, Hh, Chr, Gg, Gg, Gg, Gg, Hh, Gg, Gg, Gg, Gg, Gg, Gg, Gg, Gs^Fp, Hh, Hh, Hh, Hh
Mm, Mm, Mm, Hh, Gg, Gg, Gg, Gg, Gg, Gg, Gg, Gg, Gg, Gg^Efm, Gg^Efm, Gg, Mm, Mm, Mm, Hh, Hh, Hh
Mm, Mm, Mm, Gg^Ve, Gg, Gg, Gg, Gg, Gg, Gg, Chr, Gg, Gg^Efm, Gg^Efm, Gg^Efm, Gs^Fp, Gs^Fp, Mm, Mm, Hh, Mm, Mm
Chr, Chr, Mm, Gs^Fp, Gg, Gg, Gg, Gg, Gg, Hh, Mm, Hh, Gs^Fp, Gg, Gg^Efm, Gg^Efm, Gs^Fp, Mm, Mm, Mm, Mm, Mm
Chr, Chr, Chr, Gs^Fp, Ce, Ce, Ce, Gg, Gg^Vh, Hh, Mm, Hh, Hh, Gs^Fp, Gs^Fp, Gs^Fp, Gs^Fp, Hh, Mm, Mm, Mm, Mm
Xu, Xu, Xu, Gg, Ce, 1 Ke, Ce, Gg, Hh, Mm, Mm, Mm, Mm, Hh, Gs^Fp, Gg^Ve, Gs^Fp, Hh, Hh^Vhh, Mm, Mm^Xm, Mm^Xm
Uu, Uu, Gg, Gg, Gg, Ce, Mm, Hh, Mm, Mm, Mm, Mm, Mm^Xm, Mm^Xm, Mm, Gg^Fet, Gg^Fet, Hh, Mm, Mm, Mm^Xm, Mm^Xm
Uu, Uu, Uu, Xu, Xu, Mm, Chr, Chr, Chr, Hh^Vhh, Mm, Mm, Mm, Mm, Mm^Xm, Mm, Mm, Mm, Mm^Xm, Mm^Xm, Mm^Xm, Mm^Xm
Uu, Uu, Uu, Xu, Xu, Mm, Chr, Chr, Chr, Hh, Mm, Mm, Mm, Mm, Mm^Xm, Mm, Mm, Mm, Mm^Xm, Mm^Xm, Mm^Xm, Mm^Xm