Uu, Qxu, Qxu, Qxu, Qxu, Xu, Xu, Xu, Xu, Xu, Xu, Xu, Xu, Xu, Xu, Xu, Xu, Xu, Xu, Xu, Xu, Xu, Xu, Xu, Xu, Xu, Xu, Xu, Xu, Xu, Xu, Xu, Xu, Xu, Xu, Xu, Xu, Xu, Xu, Xu, Xu, Xu
Qxu, Qxu, Qxu^Bs\, Qxu, Qxu, Qxu, Xu, Xu, Xu, Xu, Xu, Xu, Xu, Xu, Xu, Xu, Uh, Xu, Xu, Xu, Uu, Xu, Xu, Xu, Xu, Xu, Xu, Xu, Ww, Xu, Xu, Xu, Xu, Xu, Xu, Xu, Xu, Xu, Xu, Xu, Xu, Xu
Qxu, Qxu, Qxu, Uu, Re, Qxu, Re, Uue, Uue, Xu, Xu, Xu, Xu, Xu, Xu, Xu, Ur, Uu, Uh, Ww, Uu, Uu, Xu, Xu, Xu, Xu, Wwf, Ww, Xu, Ww, Xu, Xu, Xu, Xu, Xu, Xu, Xu, Xu, Xu, Xu, Xu, Xu
Qxu, Qxu, Re, Re, Uu^Uf, Re, Uu, Uue, Xu, Uue, Xu, Xu, Xu, Xu, Uu, Ur, Ur, Uu, Uu, Uu, Uu^Uf, Xu, Xu, Xu, Wwf, Wwf, Xu, Xu, Xu, Ww, Ww, Wwf, Ww, Wwf, Ww, Xu, Sm, Sm, Ww, Xu, Xu, Xu
Qxu, Qxu, Qxu, Uu^Uf, Qxu, Re, Xu, Xu, Xu, Uue, Re, Xu, Qxu, Xu, Uu, Uu, Xu, Xu, Uu, Uu, Xu, Xu, Xu, Xu, Wwf, Ww, Xu, Xu, Xu, Xu, Xu, Xu, Ww, Xu, Xu, Ww, Ww, Ww, Uu^Uf, Ww, Xu, Xu
Xu, Qxu, Qxu, Qxu, Xu, Xu, Xu, Xu, Xu, Rd, Rd, Re, Uu, Qxu, Ur, Uu, Xu, Xu, Xu, Uu, Xu, Xu, Xu, Ww, Ww, Ww, Ww, Xu, Wwf, Wwf, Wwf, Wwf, Ww, Xu, Xu, Wo, Ww, Ww, Ww, Xu, Xu, Xu
Xu, Xu, Qxu, Qxu, Qxu, Xu, Rd, Rd, Uu, Rd, Uu, Rd, Xu, Uu, Ur, Uu^Uf, Uu, Xu, Xu, Xu, Xu, Xu, Xu, Xu, Xu, Xu, Ww, Xu, Ww, Xu, Xu, Xu, Ww, Ww, Xu, Wo, Ww, Ww, Uh, Ww, Xu, Xu
Xu, Qxu, Ds, Xu, Ds, Xu, Rd, Xu, Xu, Uh, Xu, Xu, Xu, Xu, Xu, Uu, Uu, Xu, Xu, Xu, Xu, Xu, Xu, Xu, Xu, Xu, Xu, Xu, Uh, Ww, Wwf, Xu, Ww, Sm, Xu, Xu, Xu, Ww, Xu, Xu, Xu, Xu
Xu, Ds, Ds, Ds, Uu^Uf, Ds, Xu, Xu, Xu, Xu, Xu, Xu, Xu, Xu, Xu, Uu, Uu, Xu, Cud, Xu, Xu, Xu, Cud, Xu, Xu, Xu, Xu, Xu, Xu, Ww, Ww, Xu, Xu, Xu, Xu, Xu, Xu, Wwf, Wwf, Xu, Xu, Xu
Xu, Ds, Ds, Ds, Xuc, Xu, Xu, Xu, Xu, Xu, Chw, Ww, Xu, Xu, Xu, Uu, Kh, Cud, Uu, Xu, Xu, Xu, Uu, Cud, Kh, Uu, Uu, Xu, Xu, Xu, Xu, Xu, Wwr, Xu, Xu, Xu, Xu, Xu, Ww, Xu, Xu, Xu
Xu, Uu^Uf, Ds, Ds, Xu, Xu, Uu^Uf, Uu, Uu, Rb, Rb, Kh, Xu, Xu, Xu, Xu, Cud, Uu, Uu, Xu, Xu, Xu, Uu, Uu, Cud, Uu, Uu, Uu, Uu, Xu, Xu, Ww, Ww, Chw, Kh, Xu, Xu, Xu, Xu, Wwf, Xu, Xu
Xu, Xuc, Xuc, Xuc, Xu, Xu, Re, Uu^Uf, Uu, Uu, Uu, Chr, Xu, Xu, Xu, Xu, Cud, Uu, Xu, Xu, Urb, Xu, Xu, Uu, Cud, Xu, Xu, Uu, Uu, Xu, Xu, Ww, Ww, Chw, Chw, Xu, Xu, Xu, Xu, Wwf, Xu, Xu
Xu, Xu, Xuc, Xu, Xu, Xu, Re, Re, Xu, Uu, Xu, Xu, Xu, Xu, Xu, Xu, Xu, Xu, Re, Urb, Ch, Rb, Uu^Uf, Xu, Xu, Xu, Xu, Uu, Xu, Xu, Xu, Ww, Ww^Vm, Wwr, Xu, Xu, Xu, Sm, Wwf, Ww, Xu, Xu
Qxu, Xu, Qxu, Xu, Re, Re, Xu, Xu, Uu, Uu, Xu, Xu, Xu, Xu, Xu, Xu, Rb, Re, Urb, Re, Urb, Re, Urb, Urb, Urb, Xu, Xu, Xu, Xu, Xu, Xu, Xu, Xu, Xu, Xu, Xu, Ww, Wwf, Ww, Ww, Xu, Xu
Qxu, Qxu, Qxu, Xu, Uu, Uh, Xu, Xu, Xu, Xu, Rr, Xu, Xu, Xu, Xu, Xu, Urb, Chr, Urb, Uu^Uf, Ch, Urb, Urb, Chr, Urb, Xu, Xu, Rr, Cud, Cud, 4 Kud, Cud, Cud, Rr, Xu, Xu, Ww, Xu, Xu, Ww, Xu, Xu
Xu, Xu, Xu, Qxu, Uu, Uu^Uf, Xuc, Xuc, Xuc, Cud, Xuc, Xuc, Xu, Xu, Xu, Xu, Urb, Urb, Re, Ch, Kh, Chr, Urb, Urb, Urb, Xu, Xu, Rr, Rr, Cud, Rr, Cud, Rr, Rr, Xu, Xu, Xu, Ww, Xu, Xu, Xu, Xu
Xu, Xu, Ww, Uu, Xuc, Xu, Xuc, Xu, Xu, Rr, Cud, Rr, Xu, Xu, Xu, Xu, Urb, Re, Re, Chr, Chr, Ch, Urb, Urb, Urb, Xu, Xu, Rr, Rr, Rr, Rr, Rr, Rr, Rr, Xu, Xu, Ww, Ww, Xuc, Ww, Xu, Xu
Xu, Xu, Re, Xu, Xuc, Xu, Xu, Rr, Cud, Xu, Rr, Xuc, Xuc, Xu, Xu, Xu, Urb, Ch, Urb, Urb, Urb, Urb, Urb, Chr, Urb, Xu, Xu, Xu, Xu, Rr, Xu, Rr, Xu, Xu, Xu, Xu, Wwf, Xu, Xuc, Ww, Xu, Xu
Xu, Xu, Re, Xuc, Xu, Xu, Xu, Xu, Xuc, Rr, Rr, Rr, Cud, Xu, Xuc, Xu, Xu, Urb, Urb, Urb, Chr, Rd, Rd, Rd, Xu, Xu, Xu, Xu, Rr, Xu, Rr, Xu, Rr, Xu, Xu, Xu, Xu, Wwf, Ww, Ww, Xu, Xu
Xu, Re, Re, Xu, Xu, Rr, Cud, Rr, Cud, Rr, Rr, Rr, Rr, Rr, Rr, Xuc, Xuc, Xu, Xu, Urb, Urb, Urb, Xu, Xu, Xuc, Xu, Xu, Rr, Rr, Rr, Rr, Rr, Rr, Rr, Xu, Xu, Ww, Ww, Xuc, Xu, Xu, Xu
Xu, Xuc, Re, Xu, Xu, Xu, Rr, Xu, Rr, Xu, Cud, Rr, Cud, Rr, Rr, Rr, Xuc, Xuc, Xu, Xu, Uu, Xu, Xu, Xu, Xuc, Xuc, Xu, Cud, Rr, Rr, Rr, Rr, Rr, Cud, Xu, Xu, Xu, Wwf, Sm, Xu, Xu, Xu
Xu, Xu, Xuc, Re, Xuc, Xu, Xu, Xu, Xu, Xu, Qxu, Rr, Qxu, Xu, Rr, Rr, Xuc, Xuc, Xu, Cud, Rr, Cud, Xu, Xu, Xuc, Xuc, Rr, Rr, Rr, Cud, Xu, Cud, Rr, Rr, Rr, Xu, Xu, Xu, Xuc, Sm, Xu, Xu
Xu, Xu, Rd, Ur, Xuc, Xuc, Xuc, Xu, Xu, Xu, Qxu, Qxu^Bs|, Qxu, Xu, Cud, Rr, Xuc, Xuc, Xu, Rr, Rr, Rr, Xu, Xu, Xuc, Cud, Rr, Rr, Xu, Xu, Xu, Xu, Xu, Rr, Rr, Xu, Xu, Xu, Wwf, Sm, Xu, Xu
Uu, Ur, Rd, Ur, Ur, Xuc, Uu, Uu, Xu, Xuc, Rr, Rr, Rr, Xuc, Cud, Cud, 8 Kud, Xu, Xu, Rr, Rr, Rr, Xu, Xu, Xuc, Rr, Rr, Cud, Xu, Xu, Xu, Xu, Cud, Cud, Cud, Xu, Xu, Xu, Ww, Wwf, Xu, Xu
Uu^Uf, Rd, Xu, Uh, Ww, Xuc, Uu, Uu, Xu, Xu, Rr, Rr, Rr, Xuc, Rr, Cud, Cud, Cud, Xu, Cud, Rr, Cud, Xu, Xu, Xuc, Rr, Rr, Xu, Xu, Xuc, Xuc, Xu, Xu, 9 Kud, Cud, Xu, Xu, Ww, Ww, Wwf, Xu, Xu
Ur, Xu, Ww, Ww, Xu, Ww, Xu, Xu, Xu, Xu, Rr, Rr, Rr, Xuc, Cud, Rr, Rr, Cud, Xu, Rr, Rr, Rr, Xu, Xuc, Xuc, Rr, Rr, Xu, Xu, Ww, Ww, Xuc, Xuc, Xu, Xu, Xu, Xu, Xu, Ww, Xu, Xu, Xu
Xu, Xuc, Rb, Xu, Xu, Xu, Rr, Rr, Xu, Xu, Rr, Rr, Rr, Xu, Xu, Rr, Cud, Rr, Xu, Rr, Rr, Rr, Xu, Xuc, Xuc, Rr, Rr, Xu, Xu, Ww^Vm, Xuc, Ww, Ww, Xu, Xu, Xu, Sm, Xuc, Xuc, Ww, Xu, Xu
Xu, Re, Uh, Xu, Xu, Uu^Vud, Rr, Rr, Xuc, Xu, Xu, Rr, Rr, Rr, Rr, Xu, Xu, Xu, Xu, Cud, Rr, Cud, Xu, Xu, Xuc, Cud, Rr, Xu, Xu, Xuc, Xu, Xu, Ww, Xu, Ww, Sm, Ww, Wwf, Ww, Ww, Xu, Xu
Xu, Re, Re, Xu, Xu, Rr, Rr, Rr, Ch, Xuc, Xuc, Xu, Xu, Rr, Rr, Rr, Rr, Xu, Xu, Rr, Rr, Rr, Xu, Xu, Rr, Rr, Rr, Cud, Xu, Xu, Xu, Sm, Ww, Ww, Wo, Ww, Ww, Ww, Ww, Ww, Xu, Xu
Xu, Xu, Xuc, Re, Xu, Uu^Vud, Rr, Rr, Rr, Xu, Rr, Xuc, Xu, Xu, Xu, Rr, Rr, Rr, Rr, Rr, Rr, Rr, Rr, Rr, Rr, Rr, Xu, Xu, Xu, Xu, Ur, Ww, Ww, Ww, Ww, Ww, Sm, Xu, Xu, Wwf, Uh, Rb
Xu, Uh, Re, Re, Xu, Rr, Rr, Rr, Ch, Xu, Rr, Rr, Rr, Xu, Xu, Xu, Rr, Rr, Rr, Rr, Rr, Rr, Rr, Rr, Rr, Xu, Xu, Xu, Rr, Rr, Ur, Uu^Uf, Ur, Wwf, Ww, Ww, Ww, Xu, Wwf, Wwf, Rb, Rb
Xu, Ww, Xu, Xu, Xu, Ch, 6 Kh, Rr, Xu, Xu, Xu, Rr, Rr, Rr, Rr, Rr, Rr, Rr, Xu, Cud, Xu, Cud, Xu, Rr, Rr, Rr, Rr, Rr, Rr, Rr, Ur, Uu, Uu, Wwf, Wwf, Ww, Ww, Ww, Xu, Xu, Xu, Xu
Xu, Re, Xu, Xu, Uu, Xu, Xu, Ch, Xu, Xu, Xu, Xu, Xu, Cud, Xu, Rr, Rr, Rr, Cud, Cud, Kud, Cud, Cud, Rr, Rr, Rr, Xu, Cud, Xu, Xu, Xu, Uu, Uu, Uu, Ur, Ur, Ww, Xu, Xu, Xu, Xu, Xu
Xu, Uu, Xu, Xu, Uu, Uu, Xu, Xu, Xu, Xu, Rr, Xu, Xu, Xu, Xu, Xu, Rr, Rr, Rr, Rr, Rr, Rr, Rr, Rr, Xu, Rr, Cud, Xu, Xu, Xu, Xu, Xu, Xu, Xu, Xu, Uu, Ww, Wwf, Xu, Xu, Xu, Xu
Xu, Uu, Re, Xu, Xu, Uu, Xu, Ds, Re, Xu, Xuc, Xu, Xu, Xu, Rr, Rr, Cud, Xu, Xu, Rr, Rr, Rr, Xu, Xu, Xu, Rr, Rr, Xu, Xu, Xu, Xu, Xu, Xu, Xu, Xu, Xuc, Ww, Ww, Ww, Ww, Wwf, Xu
Xu, Xu, Ds, Xu, Xu, Xu, Xu, Uu, Xu, Xu, Rr, Cud, Rr, Xuc, Rr, Rr, Rr, Xu, Xu, Cud, Rr, Cud, Xu, Xu, Xu, Rr, Rr, Xu, Xu, Xu, Uu, Uu, Uu, Xu, Xu, Xu, Wwf, Xu, Xu, Xu, Wwf, Xu
Xu, Xu, Ds, Uu, Uu, Uu^Uf, Re, Re, Xu, Xu, Rr, Rr, Xu, Rr, Rr, Rr, Rr, Xu, Xu, Rr, Rr, Rr, Xu, Xu, Xu, Rr, Xu, Xu, Rr, Xu, Xu, Uu, Xuc, Xuc, Xu, Xu, Ww, Ww, Xu, Wwf, Ww, Xu
Xu, Xu, Qxu, Qxu, Uh, Re, Xu, Xu, Rr, Xuc, Cud, Rr, Xu, Xu, Rr, Rr, Rr, Xu, Xu, Rr, Rr, Rr, Xu, Xu, Ch, Xu, Rr, Ch, Rr, Uu^Vud, Rr, Xu, Xu, Xu, Xu, Ww, Ww, Ww^Vm, Xu, Xu, Ww, Xu
Xu, Xu, Xu, Qxu, Uu, Uu, Xu, Qxu, Xu, Xu, Xu, Xuc, Xu, Xu, Rr, Rr, Rr, Xu, Xu, Rr, Rr, Rr, Xu, Xu, Rr, Ch, Rr, Ch, Rr, Rr, Ch, Xu, Xu, Xu, Xu, Xu, Xu, Xu, Ww, Ww, Xu, Xu
Xu, Xu, Xu, Xu, Re, Xu, Xu, Xu, Uh, Xu, Xu, Rr, Xu, Xu, Cud, Cud, Cud, Xu, Xu, Rr, 1 Rr, Rr, Xu, Xu, Xu, Rr, Rr, Rr, Rr, Rr, Rr, Xu, Uu, Uu, Xu, Xu, Xu, Xu, Ww, Ww, Ww, Xu
Xu, Xu, Xu, Xu, Xu, Re, Re, Re, Xu, Re, Xu, Xu, Xu, Xu, Cud, 7 Kud, Xu, Xu, Xu, Rr, Rr, Rr, Xu, Xu, Xu, Ch, 5 Kh, Ch, Rr, Uu^Vud, Xu, Xu, Uu, Uu, Xu, Xu, Xu, Xu, Xu, Ww^Vm, Xu, Xu
Xu, Xu, Xu, Xu, Xu, Xu, Xu, Xu, Xu, Xu, Xu, Xu, Xu, Xu, Xu, Xu, Xu, Xu, Xu, Rr, Rr, Rr, Xu, Xu, Xu, Xu, Xu, Xu, Xu, Xu, Xu, Xu, Xu, Xu, Xu, Xu, Xu, Xu, Xu, Xu, Xu, Xu
