border_size=1
usage=map

Xu, Xu, Xu, Xu, Xu, Xu, Xu, Xu, Xu, Xu, Xu, Xu, Xu, Xu, Xu, Xu, Xu, Xu, Xu, Xu, Xu, Xu
Xu, Xu, Xu, Xu, Chr, Xu, Re, Xu, Uu^Vud, Xu, Uu, Xu, Uu, Xu, Xu, Xu, Xu, Xu, Xu, Xu, Xu, Xu
Xu, Xu, Ch, Chr, 2 Kh, Re, Re, Re, Uu, Uu, Re, Re, Uu, Uu, Uu, Xu, Xu, Xu, Xu, Xu, Xu, Xu
Xu, Xu, Uu, Ch, Chr, Uu, Uu, Re, Uu, Re, Uu^Vud, Uu, Re, Uu, Rd, Xu, Xu, Xu, Uu, Uu, Xu, Xu
Xu, Xu, Uu, Uu, Rd, Rd, Uu, Uu, Xu, Xu, Xu, Xu, Xu, Rd, Xu, Xu, Uu, Uu, Xu, Uu, Xu, Xu
Xu, Xu, Xu, Uu^Vud, Xu, Rd, Rd, Uu, Re, Xu, Xu, Xu, Xu, Re, Xu, Uu, Xu, Xu, Xu, Uu, Xu, Xu
Xu, Xu, Xu, Xu, Xu, Xu, Re, Uu, Xu, Xu, Xu, Xu, Xu, Re, Xu, Uu, Xu, Xu, Xu, Uu, Xu, Xu
Xu, Xu, Xu, Xu, Xu, Xu, Xu, Re, Uu, Xu, Rd, Xu, Chr, Ww, Xu, Uu, Xu, Xu, Uu, Uu, Xu, Xu
Xu, Xu, Xu, Xu, Rd, Xu, Xu, Xu, Xu, Re, Chr, Rd, Rd, Ch, Uu^Vud, Uu, Xu, Xu, Uu^Vud, Xu, Xu, Xu
Xu, Xu, Rd, Rd, Xu, Rd, Rd, Xu, Uu^Vud, Xu, Uu, Rd, Chr, Chr, Uu, Xu, Xu, Xu, Xu, Xu, Xu, Xu
Xu, Xu, Rd, Xu, Xu, Xu, Xu, Rd, Xu, Chr, Ch, Uu^Vud, Chr, Rd, Rd, Xu, Xu, Xu, Xu, Xu, Xu, Xu
Rd, Rd, Xu, Xu, Xu, Xu, Xu, Xu, Xu, Uu^Vud, Rd, 1 Kh, Chr, Rd, Chr, Xu, Xu, Xu, Xu, Xu, Xu, Xu
Xu, Xu, Xu, Xu, Xu, Xu, Xu, Xu, Uu, Rd, Rd, Chr, Uu, Rd, Uu^Vud, Xu, Xu, Xu, Xu, Xu, Xu, Xu
Xu, Xu, Xu, Xu, Xu, Xu, Uu, Uu, Xu, Xu, Ch, Rd, Chw, Ch, Chr, Xu, Xu, Xu, Xu, Xu, Xu, Xu
Xu, Xu, Xu, Xu, Xu, Uu, Xu, Xu, Xu, Xu, Xu, Ww, Xu, Xu, Xu, Chr, Uu, Xu, Xu, Xu, Xu, Xu
Xu, Xu, Xu, Xu, Xu, Uu, Xu, Xu, Xu, Xu, Xu, Re, Xu, Xu, Xu, Xu, Rd, Uu, Rd, Xu, Xu, Xu
Xu, Xu, Xu, Xu, Xu, Uu, Xu, Xu, Xu, Xu, Xu, Re, Xu, Xu, Xu, Xu, Re, Uu, Uu^Vud, Rd, Xu, Xu
Xu, Xu, Xu, Xu, Uu, Uu, Xu, Xu, Xu, Xu, Xu, Uu, Uu, Xu, Rd, Uu^Vud, Uu, Rd, Rd, Uu, Xu, Xu
Xu, Xu, Uu, Uu, Xu, Xu, Xu, Xu, Xu, Xu, Xu, Xu, Re, Uu, Uu^Vud, Uu, Uu, Re, Ch, Uu, Xu, Xu
Xu, Xu, Uu, Uu, Xu, Xu, Xu, Xu, Xu, Xu, Xu, Xu, Rd, Rd, Uu, Uu, Chr, Chr, Chr, Uu, Xu, Xu
Xu, Xu, Xu, Uu^Vud, Xu, Xu, Xu, Xu, Xu, Xu, Xu, Xu, Xu, Re, Xu, Uu, Xu, 3 Kh, Xu, Chr, Xu, Xu
Xu, Xu, Xu, Xu, Xu, Xu, Xu, Xu, Xu, Xu, Xu, Xu, Xu, Xu, Xu, Xu, Xu, Xu, Xu, Xu, Xu, Xu
