border_size=1
usage=map

Xu, Xu, Xu, Xu, Xu, Xu, Xu, Xu, Xu, Mm, Mm, Mm, Hh, Gg, Gg, Gg, Re, Gg, Re, Gs^Fp, Mm, Mm, Xu, Xu, Xu, Xu, Xu, Xu, Xu, Xu, Xu, Xu
Xu, Xu, Xu, Xu, Xu, Xu, Xu, Xu, Xu, Mm, Mm, Mm, Hh, Gg, Gg, Gg, Re, Gg, Re, Gs^Fp, Mm, Mm, Xu, Xu, Xu, Xu, Xu, Xu, Xu, Xu, Xu, Xu
Xu, Xu, Xu, Xu, Xu, Xu, Xu, Xu, Xu, Xu, Hh, Hh^Vhh, Re, Re, Ce, Ce, Ce, Re, Re, Hh^Vhh, Hh, Mm, Xu, Xu, Xu, Xu, Xu, Xu, Xu, Xu, Xu, Xu
Xu, Xu, Xu, Xu, Xu, Xu, Xu, Xu, Xu, Xu, Rd, Hh, Rd^Ii, Rd, Ce^Ii, 2 Ke, Ce, Rd, Rd^Ii, Rd^Ii, Rd, Xu, Xu, Xu, Xu, Xu, Xu, Xu, Xu, Xu, Xu, Xu
Qxu, Qxu, Qxu, Xu, Xu, Xu, Xu, Xu, Xu, Xu, Uu^Uf, Rd, Uu^Ufi, Uu^Uf, Ce^Ii, Ce^Ii, Ce^Ii, Rd^Ii, Uu, Uh, Uu^Uf, Xu, Xu, Xu, Xu, Xu, Xu, Xu, Xu, Xu, Xu, Xu
Xu, Xu, Xu, Qxu, Xu, Xu, Xu, Xu, Xu, Uh, Uu, Uu, Uh, Uu^Uf, Uu^Ii, Uu^Ii, Uu, Uu, Uu, Uu^Uf, Uu^Uf, Uh, Xu, Xu, Xu, Xu, Xu, Xu, Xu, Xu, Xu, Xu
Xu, Xu, Xu, Qxu, Xu, Xu, Xu, Xu, Xu, Uh, Uu, Uu, Uu, Uu, Uu, Uu, Uu, Uu, Uu, Uu, Uu, Uh, Xu, Xu, Xu, Xu, Xu, Xu, Xu, Xu, Xu, Xu
Xu, Xu, Xu, Qxu, Xu, Xu, Xu, Xu, Xu, Xu, Uu, Ch, Ch, Ch, Uu, Uu, Uu, Ch, Ch, Ch, Uu, Xu, Xu, Xu, Xu, Xu, Xu, Xu, Xu, Xu, Xu, Xu
Xu, Xu, Xu, Qxu, Qxu, Xu, Uu, Uu, Uu, Uu, Uu^Vu, Rr, Rr, Rr, Uu, Uu, Uu, Rr, Rr, Rr, Uu^Vu, Uu, Uu, Xu, Xu, Uu, Uu^Uf, Xu, Uu, Xu, Xu, Xu
Xu, Xu, Xu, Xu, Xu, Uu, Uu, Uu, Uu^Uf, Uu^Uf, Uu^Uf, Uu, Uu, Rr, Ch, Ch, Ch, Rr, Uu, Uu, Uu, Uu, Uu, Uu, Uu, Uu, Uu^Uf, Uu^Uf, Uu, Uu, Xu, Xu
Xu, Xu, Uu, Uu, Uu, Uu, Uh, Uu, Uu, Uu^Uf, Uu^Ufi, Uu, Uu, Rr, Rr, Kh, Rr, Rr, Uu, Uu, Uu, Uu, Uh, Uu, Uu^Vu, Uu, Uu, Uu^Uf, Uu, Uu, Xu, Xu
Xu, Xu, Xu, Uu, Uu, Uh, Uh, Uh, Uu, Uu, Uu^Ii, Uu^Ii, Rr, Rr, Uh, Rr, Uu^Uf, Rr, Rr, Uu, Uu, Uu, Uh, Uh, Uh, Uu, Uu, Uu, Xu, Xu, Xu, Xu
Xu, Xu, Xu, Uu^Uf, Uu, Uh, Uu, Uu^Vu, Uu, Uu^Ii, Rr^Ii, Rr^Ii, Uu, Uu, Uu, Rr, Uu^Vu, Uu^Uf, Uh, Rr, Rr, Uu, Uu, Uh, Uu, Uu, Uu, Xu, Xu, Xu, Xu, Xu
Xu, Xu, Uu^Uf, Uu^Uf, Uu, Uu, Uu, Uu, Rr, Rr, Uu, Uu^Ii, Uu, Uu, Uu^Uf, Rr, Uu^Uf, Uu, Uu, Uh, Uu, Rr, Rr, Uu, Uu, Uu, Uu, Uu^Uf, Uu^Uf, Uu^Uf, Xu, Xu
Xu, Xu, Uu, Uu, Uu, Uu, Uu, Uu, Rr, Uu, Uu, Uu, Uu^Uf, Uu^Uf, Cud, Rr, Cud, Uu^Uf, Uu^Uf, Uu, Uu, Uu, Rr, Uu, Uu, Uu, Uu^Uf, Uu^Uf, Ww, Ww, Xu, Xu
Xu, Xu, Ww, Xu, Xu, Uu, Uh, Uh, Rr, Uh, Uh, Uh, Uu^Uf, Uu^Uf, Ww, Rr, Ww, Wo, Wo, Uu, Uu, Cud, Ww^Bw|, Cud, Ww, Uu, Uu, Uu^Uf, Ww, Ww, Wo, Wo
Wo, Wo, Ww, Ww, Wo, Uh, Uh, Cud, Ww^Bw|, Cud, Ww, Wo, Wo, Wo, Cud, Ww^Bw|, Cud, Uu^Uf, Uu^Uf, Wo, Ww, Ww, Ww^Bw|, Ww, Xu, Ww, Ww, Ww, Uu, Xu, Xu, Xu
Xu, Xu, Ww, Uu^Uf, Uu^Uf, Wo, Wo, Ww, Ww^Bw|, Ww, Uh, Uu^Uf, Uu, Uu^Uf, Uu^Ufi, Rr, Uu, Uu^Uf, Uu, Uu, Uu, Ww, Rr, Ww, Ww, Ww, Uu, Uu, Uu, Xu, Xu, Xu
Xu, Xu, Uu, Uu^Uf, Uu, Uu^Uf, Uh, Cud, Rr, Cud, Uh, Uu, Uu, Uu^Ii, Uu^Ii, Rr^Ii, Uu^Ii, Uu, Uu, Uu, Uu, Cud, Rr, Cud, Uu, Uu, Uu, Uu, Uu, Uu, Xu, Xu
Xu, Xu, Xu, Xu, Xu, Uu, Uu, Uh, Uu, Rr, Rr, Uu, Uu^Uf, Uu^Uf, Uu^Vud, Rr, Uu, Uh, Uu^Uf, Uu, Rr, Rr, Uu, Uu, Uu, Uu, Uu, Uu, Uu, Uu, Xu, Xu
Xu, Xu, Uu, Xu, Uu^Uf, Uu^Uf, Uu^Vud, Uu, Uu, Uu, Uu^Uf, Rr, Rr, Uh, Uh, Rr, Uh, Uh, Rr, Rr, Uu, Uu, Uu, Uu, Uu^Uf, Uu, Uu, Uu, Uu, Uu, Xu, Xu
Xu, Xu, Uu, Uu, Uu^Uf, Uu^Uf, Uu^Uf, Uu, Uu, Uu, Uu, Uu^Uf, Uu, Rr, Rr, Rr, Rr, Rr, Uh, Uh, Uu, Uu, Uu, Uu^Uf, Uu^Uf, Uu^Vud, Uu^Uf, Uu, Uu, Uu, Xu, Xu
Xu, Xu, Uu, Uu, Uu, Uu^Uf, Uu, Uu, Uh, Uu, Uu, Uu, Uh, Uh, Uh, Rr, Uu^Uf, Uh, Uu, Uu, Uu, Uu, Uu, Uu^Uf, Uu^Uf, Uu^Uf, Uu, Uu, Xu, Xu, Xu, Xu
Xu, Xu, Xu, Uu, Uu, Qxu, Uu, Uu, Uu, Uh, Uu, Uu, Uu, Uh, Uu, Rr, Uu^Uf, Uu, Uu, Uu, Uu, Uu, Uu, Uu, Uu, Uu, Uu, Xu, Xu, Xu, Xu, Xu
Xu, Xu, Xu, Xu, Xu, Qxu, Xu, Uu, Uu^Vud, Uu, Cud, Cud, Cud, Uu, Uu, Rr, Uu, Uu, Cud, Cud, Cud, Uu, Xu, Xu, Uu, Uu, Qxu, Qxu, Qxu, Xu, Xu, Xu
Xu, Xu, Xu, Xu, Xu, Qxu, Xu, Uu, Uu, Uu, Uu, Rr, Rr, Uu, Cud, Rr, Cud, Uu, Rr, Rr, Uu, Uu, Xu, Xu, Xu, Xu, Xu, Qxu, Qxu, Qxu, Qxu, Qxu
Xu, Xu, Xu, Xu, Qxu, Qxu, Xu, Xu, Xu, Xu, Uu, Uu, Uu, Rr, Cud, Cud, Cud, Rr, Uu, Uu, Uu, Uu^Vud, Xu, Xu, Xu, Xu, Xu, Xu, Xu, Qxu, Qxu, Qxu
Xu, Xu, Qxu, Qxu, Xu, Xu, Xu, Xu, Xu, Uu, Uh, Uu^Vud, Uu, Uu, Cud, 1 Kud, Cud, Uu, Uu^Vud, Uh, Uu^Uf, Xu, Xu, Xu, Xu, Xu, Xu, Xu, Xu, Xu, Qxu, Qxu
Qxu, Qxu, Xu, Xu, Xu, Xu, Xu, Xu, Xu, Uu^Uf, Uu^Uf, Uh, Uu, Uu, Rr, Cud, Rr, Uu, Uu, Uu^Uf, Uu^Uf, Uu^Uf, Xu, Xu, Xu, Xu, Xu, Xu, Xu, Xu, Qxu, Qxu
Xu, Xu, Xu, Xu, Xu, Xu, Xu, Xu, Xu, Xu, Uu^Uf, Uu^Uf, Uu, Uu, Rr, Rr, Rr, Uu, Uu, Uh, Uu^Uf, Uu^Uf, Xu, Xu, Xu, Xu, Xu, Xu, Xu, Xu, Qxu, Qxu
Xu, Xu, Xu, Xu, Xu, Xu, Xu, Xu, Xu, Xu, Uu^Uf, Uu^Uf, Uu, Uu, Rr, Rr, Rr, Uh, Uu, Uu, Uu, Xu, Xu, Xu, Xu, Xu, Xu, Xu, Xu, Xu, Qxu, Qxu
Xu, Xu, Xu, Xu, Xu, Xu, Xu, Xu, Xu, Xu, Uu^Uf, Uu^Uf, Uu, Uu, Rr, Rr, Rr, Uh, Uu, Uu, Uu, Xu, Xu, Xu, Xu, Xu, Xu, Xu, Xu, Xu, Qxu, Qxu
