border_size=1
usage=map

Mm, Re, Mm, Mm, Mm, Mm, Xu, Xu, Xu, Xu, Xu, Xu, Xu, Xu, Xu, Xu, Xu, Xu, Xu, Xu, Xu, Xu, Xu, Xu, Xu, Xu, Xu, Xu, Xu, Xu, Xu, Xu, Xu, Xu, Uh, Uu, Xu, Xu, Xu, Xu, Xu, Xu, Xu, Xu, Wo, Xu, Xu, Xu, Xu, Xu, Xu, Xu, Xu, Xu, Xu, Xu, Xu, Xu, Xu, Xu, Xu, Xu
Mm, Re, Mm, Mm, Mm, Mm, Xu, Xu, Dd, Xu, Dd, Dd, Dd, Xu, Xu, Xu, Ql, Ql, Ql, Xu, Ql, Xu, Ql, Xu, Xu, Xu, Xu, Xu, Xu, Xu, Ql, Xu, Xu, Xu, Xu, Uu, Uu, Xu, Rb, Rb, Rb, Xu, Uh, Xu, Xu, Wo, Xu, Xu, Xu, Xu, Xu, Xu, Xu, Xuc, Xu, Xuc, Xu, Xu, Xu, Xu, Xuc, Xu
Mm, Re, Re, Mm, Mm, Mm, Xu, Dd, Dd, Dd, Dd, Dd, Dd, Dd, Xu, Xu, Ql, Ql, Ql, Ql, Ql, Ql, Ql, Ql, Ql, Xu, Ql, Ql, Uu^Uf, Ql, Cud, Uh, Xu, Xu, Xu, Xu, Uh, Rb, Xu, Uu, Uu, Rb, Rb, Xu, Xu, Wo, Wo, Xu, Wo, Wo, Xu, Xu, Xu, Xu, Wog, Xu, Xu, Xu, Xu, Xu, Uu, Uu
Xu, Mm, Xu, Re, Xu, Xu, Xu, Dd, Dd, Dd, Cud, Cud, Dd, Dd, Dd, Xu, Xu, Ql, Ql, Ql, Ql^Ii, Ql, Uh, Ql, Ql, Ql, Rd, Uu, Uh, Cud, 2 Kud, Cud, Cud, Xu, Xu, Xu, Uh, Rb, Uu^Uf, Uu^Uf, Uh, Uh, Rb, Xu, Xu, Xu, Xu, Wo, Wo, Wo, Wo, Wo, Wo, Xu, Wwg, Xu, Xu, Uu^Uf, Rb, Uu, Xu, Xu
Xu, Xu, Re, Re^Ii, Xu, Xu, Xu, Dd, Dd^Ii, Dd^Ii, Dd^Ii, 7 Kud^Ii, Cud^Ii, Dd, Dd, Xu, Xu, Rd, Uh, Uh, Ql^Ii, Uh^Ii, Ql^Ii, Ql, Ql, Ql, Rd, Uu^Uf, Rd, Cud, Rd, Cud, Rd, Xu, Rb, Rb, Rb, Rb, Ww, Uu, Uu^Uf, Uu, Rb, Xu, Xu, Xu, Xu, Wo, Wo, Wo, Wo, Wo, Wo, Xu, Xu, Wwg, Wwf, Xu, Rb, Xu, Xu, Xu
Xu, Uue, Xu, Xu, Cud, Xu, Dd, Dd, Rd, Dd^Ii, Dd^Ii, Cud^Ii, Dd^Ii, Dd, Dd, Xu, Ql, Rd, Uu^Uf, Uu, Uu^Ufi, Uu^Ufi, Rd^Ii, Rd^Ii, Rd, Uh, Rd, Ql, Ql, Ql, Rd, Ql, Rd, Xu, Rb, Uu^Uf, Uh, Rb, Ww, Ww, Uh, Uu, Rb, Xu, Xu, Xu, Xu, Wo, Wo, Wo, Wo, Wo, Wo, Wo, Wo, Xu, Xu, Wwf, Wwf, Xu, Xu, Xu
Xu, Uue, Xu, Xu, Dd, Dd, Cud, Dd, Dd, Dd^Ii, Dd^Ii, Dd^Ii, Dd, Dd, Dd, Xu, Ql, Rd, Uu^Uf, Uu^Uf, Rd, Rd, Ql, Uu^Uf, Ql, Rd, Uh, Rd, Rd, Ql, Rd, Uu^Uf, Xu, Xu, Rb, Uh, Uu^Uf, Uh, Ww, Ww, Ww, Uh, Rb, Uu^Uf, Xu, Xu, Xu, Xu, Wo, Wo, Wo, Wo, Ww, Ww, Xu, Xu, Xu, Xu, Wwf, Xu, Xu, Xu
Xu, Dd, Dd, Xu, Dd, Qxu, Xu, Dd, Dd, Dd, Xu, Dd, Xu, Xu, Dd^Ii, Xu, Ql, Uh, Uh, Rd, Ql, Ql, Ql, Ql, Ql, Rd^Ii, Ql^Ii, Ql, Uh, Rd, Uh, Xu, Xu, Rb, Uu^Uf, Uu^Uf, Wot, Uh, Uh, Uu^Uf, Rb, Rb, Xu, Uu^Uf, Xu, Xu, Xu, Xu, Ww, Ww, Ww, Ww, Ww, Ww, Ww, Ww, Chw, Xu, Wwf, Xu, Re, Re
Xu, Xu, Xu, Dd, Xu, Xu, Xu, Dd, Dd^Ii, Dd, Xu, Xu, Ql, Cud^Ii, Rd, Cud, Ql, Ql, Rd, Chr, Uh, Uh, Uh, Ql, Ql, Ql^Ii, Ql^Ii, Ql^Ii, Xu, Uh, Xu, Xu, Uue, Uue, Uh, Uh, Xu, Wot, Wwf, Wwf, Wwf, Xu, Xu, Xu, Xu, Xu, Xu, Xu, Xu, Ww, Ww, Ww, Ww, Ww, Ww, Ww, Ww, Ch, Chr, Ww, 1 Uu, Uu
Xu, Xu, Cud, Xu, Dd, Xu, Xu, Cud^Ii, Dd^Ii, Cud^Ii, Xu, Xu, Ql, Rd, Rd, Ql, Ql^Ii, Ql^Ii, Ch^Ii, Kh, Chr, Rd, Rd, Uu^Uf, Ql, Ql^Ii, Ql, Ql, Xu, Xu, Rd, Re, Re, Uue, Xu, Xu, Xu, Xu, Wwf, Wwf, Xu, Xu, Xu, Xu, Xu, Xu, Xu, Ww, Ww, Ww, Ww, Ww, Ww, Chw, Re, Re, Chw, Kh, Re, Re, Re, Re
Xu, Xu, Dd, Rr, Rr, Cud^Ii, Xu, Dd, Rd, Dd^Ii, Xu, Xu, Xu, Ql, Rd, Ql, Ql^Ii, Ql^Ii, Ql^Ii, Ql^Ii, Rd, Uh, Uu^Uf, Ql, Rd, Ql, Xu, Xu, Xu, Uu, Uu, Uu^Uf, Uue, Uue, Xu, Xu, Uh, Xu, Wwf, Uu^Uf, Xu, Xu, Xu, Xu, Uu, Xu, Rb, Ww, Xu, Ww, Xu, Xu, Xu, Xu, Xu, Uh, Ww, Chw, Ww, Xu, Xu, Xu
Xu, Xu, Rr^Ii, Rr^Vd, Dd, Rr^Ii, Rr, Dd, Dd, Dd, Xu, Xu, Ql, Uh, Rd, Rd, Ql, Ql^Ii, Ql^Ii, Ql, Rd, Rd, Ql, Uu^Uf, Ql, Xu, Xu, Xu, Uh, Re, Uh, Xu, Xu, Xu, Xu, Uh, Uu^Uf, Wwf, Wwf, Wwf, Ww, Xu, Xu, Xu, Rd, Rb, Xu, Xu, Xu, Xu, Xu, Xu, Xu, Xu, Xu, Xu, Xu, Xu, Xu, Xu, Xu, Xu
Xu, Cud^Ii, Dd, Rr, Cud, Xu, Xu, Rd, Dd, Dd, Xu, Xu, Ql, Ql, Uh, Rd, Ql, Ql, Ql, Rd, Uh, Uh, Ql, Ql, Ql, Xu, Xu, Xu, Uh, Re, Xu, Xu, 5 Khw, Xu, Ww, Wwf, Wwf, Wwf, Uh, Wwf, Ww, Xu, Xu, Xu, Re, Re, Xu, Xu, Xu, Xu, Wo, Chr, Chr, Wo^Ii, Wo^Ii, Xu, Xu, Xu, Xu, Xu, Xu, Xu
Xu, Xu, Xu, Rr, Xu, Xu, Xu, Dd, Dd, Rd, Xu, Xu, Xu, Ql, Xu, Rd, Rd, Dd, Uh, Rd, Uu^Uf, Ql, Ql, Ql, Xu, Xu, Xu, Rd, Rd, Re, Xu, Ww, Chw, Chw, Chw, Wwf, Wwf, Wwr, Ww, Wwf, Wo, Wo, Xu, Xu, Xu, Re, Xu, Xu, Xu, Xu, Chr, Kh, Wo, Wo^Ii, Uu^Ufi, Wo, Wo, Xu, Uu, Xu, Xu, Xu
Xu, Xu, Cud^Ii, Rr^Ii, Dd, Xu, Xu, Cud, Dd, Cud, Xu, Xu, Xu, Xu, Xu, Dd, Ql, Rd, Rd, Rd, Ql, Ql, Ql, Xu, Xu, Xu, Xu, Uu^Uf, Re, Re, Xu, Ww, Chw, Wo, Wwf, Wwf, Ww^Vm, Ww, Ww, Wo, Wo, Wo, Xu, Xu, Re, Re, Re, Xu, Xu, Xu, Xu, Wo, Xu, Wo, Uh, Uh, Wo, Uh, Xu, Uu, Uh, Xu
Xu, Xu, Dd, Rr^Ii, Rr, Cud, Xu, Dd, Rd, Dd, Rr^Ii, Uu^Ufi, Rr^Ii, Xu, Xu, Ql, Ql, Ql, Ql, Uh, Ql, Ql, Ql, Xu, Xu, Xu, Xu, Uu^Uf, Re, Re, Xu, Ww, Ww, Ww, Wwf, Uu^Uf, Wwr, Wo, Wo, Wo, Wwr, Wo, Xu, Xu, Xu, Re, Re, Uh, Xu, Xu, Xu, Xu, Xu, Xu, Xu, Wo, Xu, Xu, Xu, Uh, Xu, Xu
Xu, Xu, Rr, Rr^Vd, Dd, Xu, Xu, Dd^Ii, Rd^Ii, Dd^Ii, Qxu^Ii, Rr^Ii, Qxu^Ii, Rr^Ii, Xu, Xu, Xu, Xu, Xu, Xu, Xu, Ql, Xu, Xu, Xu, Xu, Xu, Rd, Uu, Uu^Uf, Xu, Ww, Ww^Vm, Ww, Ww, Uh, Wo, Wo, Wo, Wwr, Wo, Wo, Wo, Xu, Xu, Xu, Uu^Uf, Re, Re, Xu, Xu, Xu, Re, Xu, Xu, Xu, Uh, Uh, Uh, Uh, Xu, Xu
Xu, Cud, Dd, Rr, Cud, Xu, Xu, Rd^Ii, Dd, Dd^Ii, Xu, Xu, Cud^Ii, Rr^Ii, Dd^Ii, Xu, Xu, Xu, Xu, Xu, Xu, Xu, Xu, Xu, Xu, Xu, Rd, Rd, Uh, Xu, Xu, Ww, Ww, Ww, Wwf, Ww, Wo, Uu^Uf, Wo, Wo, Wo, Wo, Wo, Chw, Xu, Xu, Xu, Re, Re, Re, Re, Re, Ur, Re, Uh, Xu, Wo, Xu, Xu, Xu, Xu, Xu
Xu, Xu, Xu, Xu, Xu, Xu, Xu, Dd, Dd, Rd, Xu, Xu, Dd, Rr^Ii, Rr, Cud, Xu, Cud, Rr, Dd, Cud, Xu, Xu, Xu, Xu, Xu, Re, Re, Xu, Xu, Xu, Xu, Ww, Wwf, Ww, Ww, Wo, Wo, Wo, Wo, Wo, Wo, Ww, Chw, Kh, Xu, Xu, Xu, Xu, Ur, Ur, Re, Xu, Re, Re, Xu, Xu, Wo, Wo, Xu, Xu, Xu
Xu, Xu, Xu, Xu, Xu, Xu, Rd, Dd, Dd, Dd^Ii, Xu, Xu, Rr, Rr^Vd, Dd^Ii, Rr^Ii, Rr, Dd, Rr^Vd, Rr, Xu, Xu, Xu, Xu, Xu, Xu, Rd, Uu^Uf, Uu, Xu, Xu, Ww, Uh, Uh, Wwf, Ww, Wo, Wo, Ww, Chw, Ww, Ww, Wo, Chw, Uu^Uf, Uh, Uh, Uh, Wwf, Xu, Xu, Xu, Xu, Uh, Ur, Xu, Xu, Xu, Uu, Xu, Xu, Xu
Xu, Xu, Dd, Dd, Dd, Dd, Rd, Rd, Xu, Xu, Xu, Cud, Dd, Rr, Cud^Ii, Xu, Cud, Rr, Rr^Ii, Dd^Ii, Xu, Xu, Xu, Xu, Xu, Xu, Rd, Re, Uu, Xu, Xu, Ww, Ww, Wwr, Wwr, Ww, Wwr, Ww, Wwf, Ww, Ww, Ww, Ww, Rb, Rb, Rb, Wwf, Rb, Rb, Ww, Wwf, Xu, Uh, Ur, Ur, Uh, Xu, Xu, Uh, Xu, Xu, Xu
Xu, Dd, Rd, Rd, Dd, Dd, Xu, Xu, Xu, Xu, Xu, Xu, Xu, Xu, Xu, Xu, Xu, Dd, Rr^Ii, Cud^Ii, Xu, Xu, Xu, Xu, Uu, Rd, Rd, Re, Xu, Xu, Xu, Ww, Ww, Ww, Wwr, Wwr, Wwr, Ww, Wwf, Chw, Ww, Ww, Ww, Ww, Uu^Uf, Xu, Xu, Xu, Wwf, Uu^Uf, Rb, Xu, Uh, Ur, Uu^Uf, Xu, Xu, Xu, Uu, Xu, Xu, Xu
Xu, Dd, Dd, Dd, Xu, Xu, Xu, Xu, Qxu, Xu, Xu, Xu, Xu, Xu, Xu, Xu, Xu, Xu, Rr, Xu, Xu, Xu, Xu, Wo, Wo, Uu, Uu, Xu, Xu, Xu, Xu, Ww, Ww, Ww, Wwr, Wwr, Ww, Wo, Wwf, Ww, Xu, Ww, Xu, Xu, Xu, Xu, Xu, Xu, Uu^Uf, Wwf, Rb, Xu, Xu, Ur, Re, Xu, Xu, Uh, Uh, Xu, Xu, Xu
Xu, Dd, Dd, Xu, Xu, Xu, Xu, Kud, Cud, Qxu^Ii, Uh^Ii, Uu^Uf, Wwf, Xu, Xu, Xu, Xu, Xu, Dd, Xu, Kud^Ii, Xu, Wo, Wo, Ww, Uu, Xu, Xu, Xu, Xu, Xu, Xu, Xu, Xu, Xu, Ww, Ww, Wwf, Xu, Xu, Xu, Xu, Uh, Uh, Re, Re, Rb, Wwg, Wwf, Wwf, Wwf, Xu, Xu, Re, Re, Re, Xu, Uh, Xu, Xu, Xu, Xu
Xu, Dd, Dd, Xu, Rd, Xu, Xu, Cud, Dd, Dd^Ii, Rd, Re, Re, Xu, Xu, Xu, Xu, Dd, Dd^Ii, Cud, Cud^Ii, Wo^Ii, Wo, Wo, Ww, Ww, Xu, Xu, Kh, Xu, Xu, Xu, Xu, Xu, Ww, Ww, Xu, Xu, Xu, Xu, Uu^Uf, Xu, Re, Uh, Re, Ur, Uu^Uf, Sm, Rb, Wwf, Re, Xu, Xu, Xu, Ur, Re, Xu, Wo, Xu, Xu, Xu, Xu
Xu, Dd, Dd, Rd, Uu^Uf, Rd, Rd, Dd, Cud, Uu^Uf, Uu^Uf, Rd, Rd, Uu^Uf, Xu, Xu, Xu, Uh^Ii, Cud^Ii, Uue, Ww, Wo, Wo, Wo, Wwf, Ww, Xu, Xu, Chw, Chw, Chw, Ww, Xu, Xu, Ww, Xu, Xu, Xu, Re, Re, Re, Re, Re, Re, Xu, Ur, Ur, Xu, Xu, Rb, Re, Re, Ur, Uu^Uf, Re, Re, Xu, Wo, Xu, Xu, Xu, Xu
Xu, Qxu, Xu, Dd, Dd, Dd, Xu, Cud, Kud, Uh, Xu, Xu, Rd, Rd, Xu, Xu, Xu, Xu, Kud, Cud, Ww, Wo, Wwf, Wwf, Ww, Ww, Xu, Ww, Ww, Ww^Ii, Ww^Ii, Uh, Xu, Xu, Ww, Xu, Xu, Re, Uu^Uf, Re, Uh, Re, Xu, Xu, Ur, Ur, Ur, Xu, Uu^Uf, Ur, Xu, Re, Re, Ur, Re, Xu, Xu, Uu, Xu, Xu, Xu, Xu
Xu, Xu, Xu, Xu, Xu, Xu, Xu, Xu, Xu, Xu, Xu, Rd, Rd, Uh, Xu, Xu, Xu, Xu, Xu, Ww, Ww, Ww, Wwf, Wwf, Xu, Xu, Xu, Ww, Ww, Uu^Ufi, Ww, Xu, Ww, Wwf, Xu, Xu, Re, Re, Re, Xu, Xu, Xu, Xu, Re, Re, Uu^Uf, Xu, Xu, Uu, Ur, Xu, Xu, Xu, Re, Xu, Xu, Xu, Uh, Uh, Xu, Xu, Xu
Uu^Uf, Xu, Rd, Uu^Uf, Uu^Uf, Xu, Rd, Uh, Rd, Rd, Rd, Rd, Rd, Xu, Xu, Xu, Xu, Xu, Xu, Xu, Xu, Uh, Xu, Xu, Xu, Xu, Xu, Xu, Xu, Ww, Xu, Xu, Wwf, Wwf, Xu, Xu, Xu, Re, Re, Xu, Xu, Xu, Re, Re, Uh, Xu, Xu, Xu, Ur, Xu, Ur, Ww, Ww, Xu, Xu, Xu, Xu, Xu, Xu, Uh, Xu, Xu
Uu, Rd, Uh, Rd, Rd, Rd, Uh, Rd, Rd, Rd, Rd, Rd, Xu, Xu, Xu, Xu, Xu, Xu, Xu, Xu, Xu, Xu, Xu, Xu, Xu, Xu, Xu, Xu, Xu, Ww, Xu, Xu, Ww, Xu, Xu, Xu, Re, Re, Uu^Uf, Xu, Re, Re, Re, Uh, Xu, Xu, Xu, Xu, Xu, Ur, Xu, Ww, Ww, Uu, Uu, Uu, Uu^Uf, Uu^Uf, Wo, Wo, Xu, Xu
Qxu, Rd, Uh, Xu, Xu, Uh, Xu, Xu, Xu, Xu, Xu, Xu, Xu, Xu, Xu, Xu, Xu, Xu, Uh, Uh, Uh, Uh, Xu, Xu, Xu, Xu, Uue, Xu, Xu, Ww, Ww, Xu, Ww, Xu, Xu, Xu, Uh, Re, Xu, Xu, Uh, Re, Uu^Uf, Xu, Ur, Xu, Uu^Uf, Xu, Xu, Xu, Uu^Vud, Xu, Xu, Xu, Xu, Xu, Xu, Wo, Xu, Xu, Xu, Xu
Qxu, Rd, Rd, Uh, Rd, Xu, Uh, Uu^Uf, Uh, Xu, Xu, Xu, Xu, Xu, Uu, Xu, Uh, Uh, Uh, Uu^Uf, Ww, Uh, Uue, Uue, Uu, Uue, Uue, Xu, Xu, Xu, Xu, Ww, Xu, Xu, Re, Re, Re, Re, Re, Xu, Xu, Re, Ur, Ur, Re, Ur, Re, Ur, Re, Xu, Uu, Xu, Uu^Vud, Xu, Xu, Xu, Xu, Xu, Xu, Xu, Xu, Xu
Xu, Xu, Xu, Rd, Rd, Rd, Rd, Rd, Rd, Uh, Rd, Uu^Uf, Uu^Uf, Uu, Uu, Xu, Uu, Uh, Uu, Uu^Uf, Re, Re, Re, Rd, Rd, Rd, Uue, Uu^Uf, Uue, Xu, Xu, Xu, Xu, Wwf, Re, Uu^Uf, Re, Re, Xu, Xu, Xu, Xu, Xu, Uu^Uf, Xu, Uu, Uh, Uh, Uu, Ur, Uu^Uf, Uu, Xu, Xu, Xu, Xu, Xu, Xu, Xu, Xu, Xu, Xu
Xu, Xu, Xu, Xu, Xu, Uu^Uf, Xu, Xu, Xu, Rd, Rd, Uu, Rd, Rd, Rd, Uu, Rd, Uue, Rd, Rd, Uh, Rd, Uh, Uh, Uu^Uf, Uu^Uf, Uue, Uue, Uu, Uh, Uue, Xu, Xu, Xu, Re, Re, Re, Xu, Xu, Xu, Xu, Xu, Xu, Xu, Xu, Xu, Xu, Xu, Ur, Xu, Uu^Uf, Xu, Xu, Xu, Uu^Vud, Xu, Xu, Xu, Xu, Xu, Xu, Xu
Xu, Xu, Uh, Ww, Ww, Xu, Uh, Xu, Xu, Uu, Uu, Rd, Rd, Rd, Rd, Rd, Uu, Uu, Rd, Rd, Uue, Uu^Uf, Uu^Uf, Uue, Xu, Xu, Xu, Uue, Uu, Uu^Uf, Xu, Xu, Xu, Xu, Xu, Re, Re, Re, Xu, Xu, Xu, Xu, Xu, Xu, Xu, Xu, Xu, Xu, Ur, Ur, Uu, Uh, Xu, Xu, Uu, Xu, Xu, Xu, Xu, Xu, Xu, Xu
Xu, Xu, Uh, Xu, Xu, Uu, Xu, Uh, Xu, Uu, Re, Uu^Uf, Uu, Rd, Uu^Uf, Rd, Rd, Xu, Rd, Uu^Uf, Xu, Uue, Xu, Xu, Xu, Xu, Uue, Uu^Uf, Uu, Uu^Uf, Xu, Xu, Xu, Xu, Xu, Xu, Uh, Re, Uh, Uh, Uu^Uf, Xu, Xu, Xu, Uu^Vud, Xu, Xu, Xu, Uu^Uf, Xu, Rb, Uh, Xu, Xu, Uu, Xu, Xu, Uu^Vud, Uu, Xu, Xu, Xu
Xu, Xu, Xu, Ww, Uh, Xu, Xu, Uh, Uh, Wwf, Xu, Uu, Xu, Uu^Uf, Xu, Xu, Xu, Rd, Xu, Xu, Xu, Xu, Xu, Xu, Xu, Xu, Uu, Uue, Uu, Xu, Xu, Xu, Xu, Xu, Uh, Uh, Uu^Uf, Re, Re, Uu^Uf, Uu^Uf, Xu, Xu, Xu, Xu, Uu, Uu, Xu, Xu, Uu^Uf, Ww, Ww, Ur, Ur, Uu^Uf, Xu, Xu, Xu, Re, Xu, Xu, Xu
Xu, Xu, Xu, Xu, Uu, Xu, Xu, Xu, Xu, Xu, Xu, Xu, Xu, Xu, Xu, Xu, Xu, Xu, Xu, Xu, Xu, Xu, Xu, Xu, Uh, Uh, Uh, Uu, Xu, Xu, Xu, Xu, Xu, Xu, Uh, Ww, Re, Re, Xu, Uh, Xu, Xu, Xu, Xu, Xu, Xu, Xu, Uu, Uu, Rb, Chr, Uu, Re, Qxu, Uu, Xu, Ur, Uu, Xu, Xu, Xu, Xu
Xu, Xu, Uh, Xu, Uu, Xu, Xu, Xu, Xu, Xu, Xu, Xu, Xu, Xu, Xu, Xu, Uh, Xu, Xu, Xu, Uu, Uu^Uf, Uu, Uu, Uu^Uf, Uh, Qxu, Qxu, Qxu, Qxu, Xu, Xu, Xu, Xu, Uh, Re, Re, Re, Xu, Xu, Xu, Xu, Uu^Vud, Uu, Uu, Xu, Xu, Ur, Uh, Uu, Uu^Uf, Rb, Rb, Re, Ur, Ur, Xu, Xu, Xu, Xu, Xu, Xu
Xu, Uh, Xu, Uh, Xu, Xu, Xu, Xu, Uu, Xu, Uu, Uh, Uu, Xu, Uu^Uf, Uh, Uu^Uf, Uu, Ur, Uu^Uf, Uu^Uf, Uu^Uf, Ur, Wo, Uu, Qxu, Uh, Uu^Uf, Uu, Xu, Xu, Xu, Xu, Xu, Xu, Xu, Re, Re, Xu, Xu, Xu, Xu, Xu, Uu^Uf, Uu, Xu, Uu, Ur, Uu, Rb, Ww, Khr, Uu, Uh, Ur, Xu, Xu, Xu, Xu, Xu, Xu, Xu
Xu, Uh, Ql^Ii, Xu, Xu, Uh, Uu, Uu, Ch, Re, Ww, Uh, Uu, Xu, Xu, Ww, Ur, Uu, Uu, Uu, Ur, Uu, Uu^Uf, Ur, Qxu, Qxu, Uu, Re, Xu, Xu, Xu, Xu, Uu, Uu, Ur, Ur, Re, Re, Xu, Xu, Xu, Xu, Xu, Xu, Xu, Uu, Xu, Ur, Rb, Uh, Uu^Uf, Uu, Ur, Ur, Uu, Xu, Uh, Uu^Vud, Xu, Xu, Xu, Xu
Xu, Uu^Ii, Chr, Xu, Xu, Uh, 6 Kh, Ch, Re, Re, Re, Uu^Uf, Uu, Xu, Uu, Uu^Uf, Re, Ur, Uu, Qxu, Qxu, Ur, Qxu, Uu^Uf, Qxu, Uu, Re, Re, Uu, Xu, Re, Uu, Re, Ur, Kh, Uu, Xu, Xu, Xu, Xu, Chr, Chr, Xu, Xu, Xu, Xu, Xu, Ur, Uu, Uu^Uf, Uh, Uu, Ur, Uu, Xu, Uu, Xu, Uh, Xu, Xu, Xu, Xu
Xu, Chr, Chr, Xu, Xu, Chr, Chr, Re, Uu^Uf, Re, Re, Re, Re, Uu, Re, Re, Uu^Uf, Uu, Qxu, Qxu, Uu, Qxu, Uu^Uf, Qxu, Re, Qxu, Qxu, Uu, Re, Re, Xu, Re, Ch, Chr, Uu, Uu, Xu, Xu, Kh, Chr, Uu^Uf, Qxu, Qxu^Ii, Xu, Xu, Xu, Ur, Ur, Ur, Rb, Uu, Uh, Ur, Xu, Xu, Xu, Xu, Xu, Xu, Xu, Xu, Xu
Xu, Kh, Qxu, Xu, Xu, Xu, Xu, Xu, Xu, Uu^Uf, Qxu, Uu, Re, Re, Uu^Uf, Re, Uh, Qxu, Qxu, Uu, Uu, Uu, Uu, Uu, Re, Uu, Uu, Uu, Re, Re, Uu^Uf, Uu, Ww, Chr, Uu, Uu, Xu, Xu, Xu, Uu^Uf, Uu^Uf, Qxu, Qxu, Xu, Xu, Uu, Xu, Xu, Xu, Ur, Ur, Uu^Uf, Ur, Xu, Xu, Xu, Xu, Xu, Xu, Xu, Xu, Xu
Xu, Xu, Xu, Xu, Xu, Xu, Xu, Xu, Qxu, Qxu, Xu, Uu, Uu, Re, Re, Re, Re, Uu, Qxu, Uh, Uu, Re, Re, Re, Re, Re, Re, Re, Re, Uu, Uu, Uu, Uu^Uf, Uu, Xu, Xu, Xu, Xu, Xu, Qxu, Xu, Qxu, Xu, Xu, Xu, Uu, Uu^Vud, Xu, Xu, Ur, Xu, Xu, Ur, Xu, Xu, Xu, Xu, Xu, Xu, Xu, Xu, Xu
Xu, Xu, Xu, Xu, Qxu, Xu, Uh, Xu, Uu^Uf, Xu, Xu, Uu^Uf, Qxu, Uu, Uu, Uh, Re, Re, Re, Uu^Uf, Uu^Uf, Re, Uu, Re, Uu, Uu, Uu, Uu^Uf, Uu, Uu, Uu, Qxu, Uu^Uf, Uu^Uf, Xu, Xu, Xu, Xu, Qxu, Qxu, Qxu, Qxu, Xu, Xu, Xu, Xu, Xu, Xu, Xu, Ur, Xu, Xu, Uh, Uu, Uu^Vud, Xu, Xu, Xu, Xu, Xu, Xu, Xu
Xu, Xu, Chr, Uu^Ii, Qxu, Qxu, Xu, Uh, Qxu, Xu, Xu, Xu, Qxu, Xu, Xu, Uh, Uh, Re, Uu, Uu, Uu, Uu, Uu, Uu, Xu, Uu, Xu, Uu^Uf, Uu^Uf, Uu, Uu, Uh, Uh, Xu, Uh, Xu, Xu, Uh, Uh, Xu, Xu, Xu, Xu, Xu, Xu, Uu^Vud, Uu, Xu, Uu, Uu, Xu, Xu, Xu, Uu, Xu, Xu, Xu, Xu, Xu, Xu, Xu, Xu
Xu, Xu, Kh, Chr, Qxu, Xu, Xu, Xu, Xu, Qxu, Xu, Qxu, Xu, Xu, Xu, Xu, Xu, Uu, Xu, Xu, Xu, Uu^Uf, Xu, Xu, Xu, Xu, Xu, Xu, Xu, Xu, Xu, Xu, Xu, Uh, Xu, Uu, Uu, Uh, Xu, Xu, Xu, Xu, Xu, Xu, Xu, Xu, Ww, Ww, Xu, Uu^Uf, Xu, Xu, Xu, Xu, Xu, Xu, Xu, Xu, Xu, Xu, Xu, Xu
Xu, Xu, Xu, Chr, Qxu, Xu, Xu, Xu, Xu, Qxu, Qxu, Qxu, Xu, Xu, Xu, Xu, Xu, Xu, Xu, Xu, Xu, Xu, Xu, Xu, Xu, Xu, Xu, Xu, Xu, Xu, Xu, Xu, Xu, Xu, Xu, Xu, Xu, Xu, Xu, Xu, Xu, Xu, Xu, Xu, Xu, Xu, Xu, Xu, Xu, Xu, Xu, Xu, Xu, Xu, Xu, Xu, Xu, Xu, Xu, Xu, Xu, Xu
Xu, Xu, Xu, Xu, Xu, Xu, Xu, Xu, Xu, Xu, Xu, Xu, Xu, Xu, Xu, Xu, Xu, Xu, Xu, Xu, Xu, Xu, Xu, Xu, Xu, Xu, Xu, Xu, Xu, Xu, Xu, Xu, Xu, Xu, Xu, Xu, Xu, Xu, Xu, Xu, Xu, Xu, Xu, Xu, Xu, Xu, Xu, Xu, Xu, Xu, Xu, Xu, Xu, Xu, Xu, Xu, Xu, Xu, Xu, Xu, Xu, Xu
