border_size=1
usage=map

Uu, Uu, Re, Xu, Xu, Qxu, Qxu, Xu, Xu, Xu, Qxu, Qxu, Xu, Qxu, Xu, Xu, Xu, Xu, Xu, Xu, Xu, Xu
Uu, Uu, Re, Xu, Xu, Qxu, Qxu, Xu, Xu, Xu, Qxu, Qxu, Xu, Qxu, Xu, Xu, Xu, Xu, Xu, Xu, Xu, Xu
Uu, Uu, Re, Qxu, Qxu, Qxu, Xu, Xu, Xu, Xu, Qxu, Xu, Xu, Xu, Xu, Xu, Qxu, Qxu, Qxu, Xu, Xu, Xu
Uu, Uu, Rd, Rd, Uu, Qxu, Uu, Xu, Uu, Uu^Uf, Uu, Qxu, Uu, Rd, Re, Re, Xu, Xu, Qxu, Xu, Xu, Xu
Uu, Uu, Uu, Uu, Uu, Uu, Uu, Uu, Uu, Uu, Rd, Uu, Uu, Uu, Xu, Xu, Xu, Xu, Qxu, Xu, Xu, Xu
Uu, Uu, Xu, Qxu, Qxu, Uu, Qxu, Uu, Uu, Rd, Rd, Uu, Rd, Uu, Xu, Xu, Qxu, Qxu, Xu, Qxu, Qxu, Qxu
Xu, Xu, Qxu, Qxu, Xu, Qxu, Xu, Xu, Uu, Re, Re, Re, Uu, Uu, Uu, Qxu, Uu, Xu, Xu, Xu, Qxu, Qxu
Xu, Xu, Qxu, Xu, Xu, Qxu, Qxu, Xu, Uu, Re, Uu, Uu, Qxu, Qxu, Qxu, Uu, Xu, Uu, Uu, Uu^Uf, Qxu, Qxu
Xu, Xu, Xu, Xu, Xu, Xu, Xu, Qxu, Uu, Uu, Uu, Xu, Xu, Xu, Qxu, Xu, Xu, Qxu, Uh, Uu, Xu, Xu
Xu, Xu, Wo, Wo, Re, Xu, Re, Uh, Uu, Uu, Uu, Qxu, Qxu, Xu, Xu, Xu, Xu, Qxu, Qxu, Uu, Xu, Xu
Ww, Ww, Wo, Wo, Uu, Re, Uu, Uu, Uu, Rd, Re, Xu, Qxu, Xu, Xu, Xu, Xu, Xu, Xu, Uu, Xu, Xu
Ww, Ww, Wo, Wo, Uu^Uf, Uu, Qxu, Qxu, Uh, Re, Re, Qxu, Xu, Xu, Qxu, Xu, Qxu, Qxu, Re, Uu, Xu, Xu
Xu, Xu, Xu, Wo, Xu, Qxu, Xu, Xu, Re, Re, Uu, Xu, Xu, Qxu, Xu, Xu, Qxu, Xu, Xu, Uu, Qxu, Qxu
Xu, Xu, Xu, Xu, Xu, Qxu, Xu, Xu, Uu, Uu, Uu, Uh, Qxu, Qxu, Xu, Xu, Qxu, Xu, Xu, Uu, Qxu, Qxu
Xu, Xu, Xu, Xu, Qxu, Qxu, Uu, Uu, Rd, Rd, Re, Uu, Uu, Qxu, Qxu, Qxu, Xu, Xu, Uu, Uu, Qxu, Qxu
Xu, Xu, Xu, Xu, Uh, Uh, Uu, Uu, 1 Ke, Re, Re, Re, Uu, Uu, Uu, Uu, Uu, Uu, Uu, Qxu, Xu, Xu
Xu, Xu, Xu, Xu, Uh, Uu, Uu, Uu, Uu, Rd, Uu, Uu, Uu, Uu, Qxu, Rd, Rd, Rd, Uu, Xu, Xu, Xu
Xu, Xu, Qxu, Xu, Qxu, Re, Re, Uu, Uu, Uu, Xu, Uu, Uu^Uf, Qxu, Xu, Xu, Xu, Re, Qxu, Xu, Xu, Xu
Xu, Xu, Xu, Qxu, Xu, Qxu, Qxu, Uu, Uu, Xu, Xu, Xu, Xu, Qxu, Xu, Xu, Xu, Re, Uu, Qxu, Xu, Xu
Xu, Xu, Xu, Xu, Xu, Xu, Uu, Uu, Uu, Xu, Xu, Xu, Xu, Qxu, Qxu, Xu, Xu, Re, Re, Qxu, Xu, Xu
Xu, Xu, Xu, Xu, Xu, Xu, Uu, Re, Re, Re, Uu, Xu, Xu, Xu, Xu, Xu, Xu, Xu, Xu, Qxu, Qxu, Qxu
Xu, Xu, Xu, Xu, Xu, Xu, Uu, Re, Re, Re, Uu, Xu, Xu, Xu, Xu, Xu, Xu, Xu, Xu, Qxu, Qxu, Qxu
