border_size=1
usage=map

Hh, Hh, Hh, Hh, Mm, Hh, Mm, Hh, Mm, Mm, Mm, Hh, Hh, Hh, Hh, Hh, Gs^Fp, Gs^Fp, Gs^Fp, Gs^Fp, Hh, Hh, Mm, Mm, Mm, Mm, Mm, Mm, Mm, Mm, Mm, Mm, Mm, Mm, Mm, Mm, Mm, Hh, Hh, Hh, Hh, Ds, Ds, Ww, Ww, Ww, Wo, Wo, Wo, Wo, Wo, Wo, Wo, Wo, Wo, Wo, Wo, Wo, Wo, Wo, Wo, Wo
Hh, Hh, Hh, Hh, Mm, Hh, Mm, Hh, Mm, Mm, Mm, Hh, Hh, Hh, Hh, Hh, Gs^Fp, Gs^Fp, Gs^Fp, Gs^Fp, Hh, Hh, Mm, Mm, Mm, Mm, Mm, Mm, Mm, Mm, Mm, Mm, Mm, Mm, Mm, Mm, Mm, Hh, Hh, Hh, Hh, Ds, Ds, Ww, Ww, Ww, Wo, Wo, Wo, Wo, Wo, Wo, Wo, Wo, Wo, Wo, Wo, Wo, Wo, Wo, Wo, Wo
Mm, Mm, Mm, Mm, Mm, Mm, Mm, Mm, Mm, Mm, Mm, Mm, Hh, Hh, Gs^Fp, Gs^Fp, Gs^Fp, Gs^Fp, Gs^Fp, Hh, Hh, Hh, Mm, Mm, Mm, Mm, Mm, Mm, Mm, Mm, Mm, Mm, Mm, Mm, Mm, Mm, Mm, Mm, Mm, Hh, Hh, Ds, Ds, Ww, Wo, Wo, Wo, Wo, Wo, Wo, Wo, Wo, Wo, Wo, Dd, Dd, Ww, Wo, Ww, Wo, Wo, Wo
Mm, Mm, Mm, Mm, Mm, Mm, Mm, Mm, Mm, Mm, Mm, Mm, Gs^Fp, Gs^Fp, Gs^Fp, Gs^Fp, Gs^Fp, Hh, Hh, Gs^Fp, Gs^Fp, Hh, Hh, Mm, Mm, Mm, Mm, Mm, Mm, Mm, Mm, Mm, Mm, Mm, Mm, Mm, Mm, Mm, Mm, Hh, Hh, Ds, Ww, Ww, Wo, Wo, Wo, Wo, Wo, Wo, Wo, Wo, Wo, Wo, Ww, Ww, Ds, Wo, Ww, Ww, Wo, Wo
Mm, Mm, Mm, Mm, Mm, Mm, Mm, Mm, Mm, Mm, Hh, Hh, Gs^Fp, Gs^Fp, Gs^Fp, Gs^Fp, Hh, Hh, Gs^Fp, Gs^Fp, Mm, Gs^Fp, Hh, Hh, Hh, Mm, Hh, Mm, Mm, Mm, Mm, Mm, Mm, Mm, Mm, Mm, Mm, Mm, Mm, Hh, Hh, Ds, Ww, Wo, Ww, Wo, Wo, Wo, Wo, Wo, Ww, Wo, Ww, Ww, Ds, Ds, Gg, Ds, Ds, Ww, Wo, Wo
Mm, Mm, Mm, Mm, Mm, Mm, Mm, Mm, Mm, Hh, Hh, Hh, Gg, Gs^Fp, Hh, Hh, Mm, Mm, Mm, Mm, Mm, Gs^Fp, Mm, Mm, Mm, Hh, Hh, Hh, Hh, Hh, Hh, Mm, Mm, Mm, Hh, Mm, Mm, Mm, Hh, Hh, Hh, Ds, Ds, Ww, Ww, Ww, Ww, Wo, Ww, Ww, Ds, Ww, Ww, Ww, Ds, Gg, Ds, Ds, Ds, Ww, Wo, Wo
Mm, Mm, Mm, Mm, Mm, Mm, Mm, Mm, Hh, Hh, Gs^Fp, Gg, Gg, Hh, Hh, Mm, Mm, Mm, Mm, Mm, Mm, Mm, Mm, Mm, Mm, Hh, Hh^Vhh, Hh, Hh, Hh^Vhh, Hh, Hh, Hh, Hh, Hh, Hh, Hh, Hh, Hh, Hh, Gs^Fp, Ds, Gs^Fp, Ds, Ds, Ww, Wo, Wo, Ww, Ds, Ds, Ds, Ds, Ds, Gg, Gg, Ds, Ww, Ww, Ww, Wo, Wo
Mm, Mm, Mm, Mm, Mm, Mm, Mm, Hh, Hh, Gs^Fp, Gs^Fp, Gg, Gg, Gg, Hh, Mm, Mm, Mm, Mm, Mm, Mm, Mm, Mm, Mm, Mm, Mm, Mm, Hh, Hh^Vhh, Gs^Fp, Gg, Gg^Vh, Gg, Hh, Gg, Hh, Gg, Hh, Gs^Fp, Gs^Fp, Gs^Fp, Gs^Fp, Gg, Gg, Ds, Ww, Wo, Wo, Ww, Ww, Ds, Gg, Gg^Efm, Gg, Gg, Gg, Ds, Ds, Ww, Wo, Wo, Wo
Mm, Mm, Mm, Mm, Mm, Mm, Hh, Hh, Gs^Fp, Gs^Fp, Gg, Gg, Gg^Efm, Gg^Efm, Hh, Hh, Hh, Mm, Mm, Mm, Mm, Mm, Mm, Mm, Mm, Mm, Mm, Hh, Gs^Fp, Gs^Fp, Gg, Gg^Vh, Gg, Gg^Vh, Gg, Ce, Gg, Gg, Re, Gg, Gg, Gg, Gg, Gg, Ds, Ww, Wo, Wo, Ww, Ds, Ds, Gg, Gg^Efm, Gg^Efm, Ds, Ds, Ww, Ww, Ds, Ww, Ww, Ww
Mm, Mm, Mm, Mm, Hh, Hh, Hh, Hh, Gs^Fp, Gs^Fp, Gg, Gg, Gg^Efm, Gs^Fp, Gs^Fp, Hh, Hh, Mm, Mm, Mm, Mm, Mm, Mm, Mm, Mm, Mm, Mm, Gs^Fp, Gg, Gg^Vh, Gg, Gg, Gg, Gg^Vh, Gg^Vh, Ce, Gg, Re^Gvs, Re^Gvs, Re^Gvs, Re, Re, Gg, Gg, Ds, Ww, Ww, Wo, Wo, Ww, Ds, Gg, Ds, Ds, Ww, Ww, Ds, Ds, Gg, Ds, Ds, Ds
Hh, Hh, Hh, Hh, Hh, Hh, Hh, Gs^Fp, Gs^Fp, Gg, Gg, Gg^Efm, Gs^Fp, Gs^Fp, Gs^Fp, Gs^Fp, Hh, Hh, Mm, Mm, Mm, Mm, Mm, Mm, Mm, Mm, Gg, Gg^Vh, Ce, Gg^Vh, Ce, Gg^Vh, Ce, Gg, Gg, Ce, Gg, Re^Gvs, Re^Gvs, Re^Gvs, Re^Gvs, Re, Re^Gvs, Gg, Gg, Ds, Ds, Ww, Ww, Ww, Ds, Gg, Ds, Ww, Ds, Ds, Gg, Gg, Gg, Gg, Gg, Gg
Hh, Hh, Hh, Hh, Hh, Hh, Hh, Hh, Gg, Gg, Gg, Gg^Efm, Gg, Gs^Fp, Hh, Gs^Fp, Hh, Hh, Hh, Mm, Mm, Mm, Mm, Mm, Ce, Gg^Vh, Gg, Gg^Vh, Ce, Ce, 7 Ke, Ce, Ce, Gg, Gg^Vh, Ce, Gg, Re, Re^Gvs, Re^Gvs, Re^Gvs, Re^Gvs, Re^Gvs, Gg, Re^Gvs, Gg, Gg, Ds, Ds, Ds, Gg, Ds, Ww, Ww, Ds, Gg, Re^Gvs, Gg, Re, Gg, Gg, Gg
Hh, Hh, Hh, Hh, Hh, Hh, Hh, Hh, Hh, Gg, Gg, Gg^Efm, Gg^Efm, Gs^Fp, Hh, Hh, Hh, Hh, Hh, Hh, Hh, Hh, Hh, Hh, Ce, Gg, Gg^Vh, Gg, Ce, Ce, Ce, Ce, Ce, Gg, Gg, Ce, Gg, Re, Re, Re^Gvs, Re^Gvs, Re^Gvs, Rd, Re^Gvs, Re^Gvs, Gg, Rd, Gg, Gg, Gg, Gg, Ww, Re^Gvs, Ds, Re^Gvs, Re^Gvs, Re^Gvs, Gg, Re, Gg, Gg, Gg
Hh, Hh, Mm, Mm, Mm, Hh, Hh, Hh, Hh, Gg, Gg, Gg, Gg, Gg, Gg, Hh, Hh, Hh, Hh, Hh, Hh, Hh, Hh, Hh, Ce, Gg, Gg^Vh, Gs^Fp, Gg, Gg^Vh, Gg, Gg^Vh, Gg, Gg^Vh, Gg, Ce, Gg, Gg, Re^Gvs, Re^Gvs, Re^Gvs, Rd, Re^Gvs, Rd, Rd, Rd, Gg, Rd, Rd, Gg, Ww, Ww, Re^Gvs, Re^Gvs, Re^Gvs, Re^Gvs, Re, Re, Re, Gg, Gg, Gg
Hh, Hh, Mm, Mm, Mm, Mm, Mm, Mm, Mm, Hh, Hh, Gg^Efm, Gg, Gs^Fp, Gg, Re^Gvs, Re^Gvs, Re^Gvs, Re, Re, Re^Gvs, Hh, Re, Re, Gs^Fp, Ce, Ce, Ce, Ce, Gg, Gs^Fp, Gg, Ce, Ce, Ce, Ce, Gg, Re^Gvs, Re, Re^Gvs, Rd, Rd, Gs^Fp, Gs^Fp, Gs^Fp, Gs^Fp, Ww, Gg^Efm, Ww, Ww^Bw\, Rd, Rd, Rd, Re, Re, Re, Re^Gvs, Re, Re^Gvs, Gg, Gg, Gg
Mm, Mm, Mm, Mm, Mm, Mm, Mm, Mm, Mm, Mm, Hh, Gg, Gg, Gg, Re^Gvs, Re^Gvs, Re^Gvs, Re^Gvs, Re^Gvs, Gg, Re, Re^Gvs, Re^Gvs, Gs^Fp, Re, Re, Re, Re^Gvs, Re^Gvs, Hh, Hh, Hh, Gs^Fp, Gs^Fp, Hh, Gg, Hh, Gg, Re, Re^Gvs, Rd, Gg^Efm, Gs^Fp, Gs^Fp, Ww, Ww, Gg, Ww, Re^Gvs, Rd, Re^Gvs, Re^Gvs, Re^Gvs, Re^Gvs, Re^Gvs, Re^Gvs, Re^Gvs, Re^Gvs, Gg, Gg^Efm, Gg, Gg
Mm^Xm, Mm^Xm, Mm^Xm, Mm^Xm, Mm^Xm, Mm, Mm, Mm, Mm, Mm, Hh, Hh, Re^Gvs, Re^Gvs, Gg, Re^Gvs, Gs^Fp, Re^Gvs, Re^Gvs, Gg, Rd, Re^Gvs, Gg, Re^Gvs, Gg, Gg, Re^Gvs, Re^Gvs, Re^Gvs, Re^Gvs, Re, Hh, Hh, Hh, Hh, Hh, Hh, Hh, Gg, Rd, Gg, Gg^Efm, Ww, Ww, Gs^Fp, Gs^Fp, Re^Gvs, Re^Gvs, Re^Gvs, Rd, Re^Gvs, Re^Gvs, Re^Gvs, Re^Gvs, Re^Gvs, Re^Gvs, Re^Gvs, Re, Re^Gvs, Gg, Gg, Gg
Mm^Xm, Mm^Xm, Mm^Xm, Mm^Xm, Mm, Mm, Mm, Mm, Mm, Mm, Hh, Gg, Gg, Re^Gvs, Re^Gvs, Gg, Re^Gvs, Re^Gvs, Rd, Rd, Hh, Rd, Rd, Rd, Rd, Gg, Rd, Gg, Rd, Re^Gvs, Re, Hh, Hh, Hh, Hh, Hh, Hh, Hh, Gs^Fp, Rd, Gg, Gg^Efm, Ww, Ww, Gs^Fp, Gg, Re^Gvs, Re^Gvs, Re^Gvs, Rd, Re^Gvs, Re^Gvs, Re^Gvs, Re^Gvs, Re^Gvs, Re^Gvs, Re^Gvs, Re^Gvs, Re^Gvs, Gg, Gg, Gg
Mm^Xm, Mm^Xm, Mm, Mm, Mm, Mm, Mm, Mm, Mm, Hh, Hh, Gg, Gg^Efm, Re, Re, Re^Gvs, Re, Re^Gvs, Rd, Gg^Efm, Gs^Fp, Hh, Rd, Re^Gvs, Re^Gvs, Rd, Re^Gvs, Rd, Re^Gvs, Rd, Rd, Re, Rd, Gs^Fp, Gs^Fp, Hh, Hh, Hh, Rd, Rd, Gg, Gg^Efm, Ww, Gs^Fp, Gg^Efm, Gg^Efm, Re^Gvs, Re^Gvs, Re^Gvs, Rd, Re, Re^Gvs, Re^Gvs, Re^Gvs, Re^Gvs, Re^Gvs, Re^Gvs, Re^Gvs, Re^Gvs, Gg, Gg, Gg
Mm^Xm, Mm^Xm, Mm, Mm, Mm, Mm, Mm, Mm, Mm, Hh, Gs^Fp, Gs^Fp, Gg^Efm, Re^Gvs, Gg, Re, Re^Gvs, Rd, Gg^Efm, Gg^Efm, Gs^Fp, Gg, Rd, Re^Gvs, Re^Gvs, Re^Gvs, Re, Re, Re^Gvs, Re^Gvs, Rd, Rd, Re^Gvs, Rd, Rd, Rd, Rd, Rd, Gg, Gg, Gg, Gg^Efm, Ww, Ww, Re^Gvs, Re^Gvs, Re, Gg, Gg, Rd, Re^Gvs, Re^Gvs, Re^Gvs, Re^Gvs, Re^Gvs, Re^Gvs, Re^Gvs, Re, Gg, Gg, Gg, Gg
Mm, Mm, Mm, Mm, Mm, Mm, Mm, Mm, Hh, Hh, Gg^Efm, Gg^Efm, Re^Gvs, Re^Gvs, Re^Gvs, Re^Gvs, Rd, Rd, Hh, Hh, Hh, Rd, Re, Re^Gvs, Re^Gvs, Re^Gvs, Re, Re^Gvs, Re^Gvs, Re^Gvs, Rd, Re^Gvs, Re^Gvs, Re^Gvs, Re^Gvs, Re^Gvs, Re, Re, Re, Gg, Ww, Ww, Re^Gvs, Re^Gvs, Re^Gvs, Re^Gvs, Re, Re^Gvs, Re^Gvs, Rd, Gg, Re, Gg, Gg^Efm, Re, Re, Gg, Gg, Hh, Gg, Gg, Gg
Mm, Mm, Mm, Mm, Mm, Mm, Mm, Hh, Gg, Gg, Gg, Re^Gvs, Re^Gvs, Re^Gvs, Re^Gvs, Re^Gvs, Rd, Re^Gvs, Rd, Gs^Fp, Hh, Rd, Gg, Re^Gvs, Gg^Efm, Re, Ww, Re^Gvs, Ww, Re^Gvs, Rd, Re^Gvs, Ww, Re^Gvs, Ww, Re^Gvs, Ww, Gg^Efm, Ww, Ww^Bw\, Re, Re^Gvs, Re^Gvs, Gg^Efm, Re^Gvs, Re, Re^Gvs, Re^Gvs, Re^Gvs, Rd, Gg, Gg^Efm, Hh, Gg, Hh, Hh, Hh, Hh, Gg, Gg, Gg, Gg
Mm, Mm, Mm, Mm, Mm, Mm, Mm, Hh, Hh, Gg, Gg, Re^Gvs, Gg, Re^Gvs, Re^Gvs, Re^Gvs, Rd, Rd, Re^Gvs, Rd, Rd, Rd, Gg^Efm, Gg, Ww, Ww, Ch, Ww, Ch, Ww, Ww^Bw|, Ww, Ch, Ww, Ch, Ww, Ww, Ww, Ww, Gg^Efm, Re, Re^Gvs, Re, Re^Gvs, Re^Gvs, Re^Gvs, Re^Gvs, Re^Gvs, Re^Gvs, Rd, Re, Hh, Hh, Hh, Hh, Hh, Mm, Mm, Gg, Gg, Gg^Efm, Gg^Efm
Mm, Mm, Mm, Mm, Mm, Mm, Mm, Mm, Hh, Gg, Gg, Gg, Gg, Re^Gvs, Rd, Rd, Gg, Re^Gvs, Re^Gvs, Re^Gvs, Re^Gvs, Gg^Efm, Ww, Ww, Ch, Ch, Mm, Ch, Mm, Ch, Rd, Ch, Mm, Ch, Mm, Ch, Ch, Ww, Ww, Gg^Efm, Re^Gvs, Re, Re^Gvs, Re, Re^Gvs, Re^Gvs, Re^Gvs, Re^Gvs, Re^Gvs, Rd, Re, Gg^Efm, Gg^Efm, Hh, Mm, Mm, Mm, Mm, Gg, Gg, Gg^Efm, Gg^Efm
Mm^Xm, Mm^Xm, Mm^Xm, Mm, Mm, Mm, Mm, Mm, Mm, Hh, Mm, Gg, Gg, Rd, Re^Gvs, Re^Gvs, Re^Gvs, Re^Gvs, Re^Gvs, Re^Gvs, Ww, Ww, Ch, Ch, Mm, Mm, Mm, Mm, Mm, Mm, Rd, Mm, Mm, Mm, Mm, Mm, Mm, Ch, Ch, Ww, Ww, Re^Gvs, Re^Gvs, Re, Re^Gvs, Re^Gvs, Rd, Re^Gvs, Rd, Rd, Re, Gg^Efm, Hh, Hh, Hh, Mm, Gg, Gg, Gg, Gg^Efm, Gg, Gg
Mm^Xm, Mm^Xm, Mm^Xm, Mm^Xm, Mm, Mm, Mm, Mm, Mm, Mm, Mm, Mm, Hh, Rd, Rd, Re^Gvs, Gg, Re^Gvs, Re^Gvs, Ww, Ch, Ch, Mm, Mm, Mm, Mm, Ch, Mm, Mm^Vhh, Mm, Rd, Mm, Mm^Vhh, Mm, Ch, Mm, Mm, Mm, Mm, Ch, Ch, Ww, Gg, Re, Rd, Rd, Re^Gvs, Rd, Gg, Gg, Gg, Re, Hh, Hh, Gg, Gg, Gg, Gg, Gg, Gg, Gg, Gg
Mm^Xm, Mm^Xm, Mm^Xm, Mm^Xm, Mm, Mm, Mm, Mm, Mm, Mm, Mm, Mm, Mm, Hh, Gg, Rd, Gs^Fp, Re^Gvs, Gg, Ww, Ch, Mm, Mm, Mm, Ch, Ch, Ch, Mm^Vhh, Mm^Vhh, Mm, Rd, Mm, Mm^Vhh, Mm^Vhh, Ch, Ch, Ch, Mm, Mm, Mm, Ch, Ww, Gg^Efm, Rd, Re^Gvs, Gg, Re^Gvs, Re^Gvs, Re^Gvs, Re^Gvs, Re, Re, Re, Gg, Ce, Ce, Ce, Ce, Ce, Ce, Ce, Ce
Mm^Xm, Mm^Xm, Hh, Mm, Mm, Mm, Mm, Mm, Mm, Mm, Mm^Vhh, Mm, Mm^Vhh, Hh, Gg, Rd, Re^Gvs, Gg, Gg, Ww, Ch, Mm, Mm, Ch, Ch, 5 Kh, Ch, Ch, Mm^Vhh, Mm^Vhh, Rd, Mm^Vhh, Mm^Vhh, Ch, Ch, 4 Kh, Ch, Ch, Mm, Mm, Ch, Ww, Gg^Efm, Rd, Re^Gvs, Re^Gvs, Gg^Efm, Re^Gvs, Re^Gvs, Re^Gvs, Re^Gvs, Gg, Ce, Ce, Gg^Vh, Gg, Gg^Vh, Gg, Gg^Vh, Gg, Gg^Vh, Gg
Hh, Hh, Hh, Mm, Mm, Mm, Mm, Mm^Vhh, Mm, Mm^Vhh, Mm, Mm, Mm, Mm, Gg, Rd, Re^Gvs, Re^Gvs, Re^Gvs, Ww, Ch, Mm, Mm, Mm^Vhh, Ch, Ch, Mm^Vhh, Mm^Vhh, Rd, Rd, Rd, Rd, Rd, Mm^Vhh, Mm^Vhh, Ch, Ch, Mm^Vhh, Mm, Mm, Ch, Ww, Gg, Rd, Re^Gvs, Re^Gvs, Re^Gvs, Re^Gvs, Re^Gvs, Re^Gvs, Gg, Gg, Ce, Gg, Gg, Gg, Gg, Gg, Gg^Vh, Gg, Gg^Vh, Gg
Hh, Hh, Hh, Mm, Mm, Mm, Mm, Mm, Mm^Vhh, Mm, Mm, Mm^Vhh, Mm, Mm, Ce, Rd, Re^Gvs, Re^Gvs, Rd, Ww, Ch, Mm, Mm, Mm^Vhh, Mm, Mm^Vhh, Mm^Vhh, Rd, Mm^Vhh, Ch, Ch, Ch, Mm^Vhh, Rd, Mm^Vhh, Mm^Vhh, Mm, Mm^Vhh, Mm, Mm, Ch, Ww, Rd, Rd, Re, Re^Gvs, Re^Gvs, Re^Gvs, Re, Gg, Re, Gg, Ce, Gg^Vh, Gg, Ce, Ce, Ce, Gg^Efm, Gg, Gg, Gg
Hh, Hh, Hh, Hh, Hh, Mm, Mm, Mm^Vhh, Hh^Vhh, Mm, Ce, Mm, Ce, Gg, Ce, Rd, Re^Gvs, Re, Rd, Ww^Bw\, Rd, Rd, Rd, Rd, Rd, Rd, Rd, Rd, Rd, Ch, 2 Kh, Ch, Rd, Rd, Rd, Rd, Rd, Rd, Rd, Rd, Rd, Ww^Bw/, Re, Re, Re, Re, Re, Re, Re^Gvs, Re, Re^Gvs, Re, Rd, Gg, Gg, Ce, 1 Ke, Ce, Gg^Efm, Gg^Vh, Gg, Gg
Re, Re, Re, Re, Re, Re, Re, Re, Re, Hh, Ce, Ce, Ce, Gg, Ce, Rd, Rd, Rd, Rd, Ww^Bw/, Ch, Rd, Mm, Rd, Mm, Rd, Mm^Vhh, Rd, Mm^Vhh, Ch, Ch, Ch, Mm^Vhh, Rd, Mm^Vhh, Rd, Mm, Rd, Mm, Rd, Ch, Ww^Bw\, Rd, Re, Re^Gvs, Re^Gvs, Re^Gvs, Gg^Efm, Re^Gvs, Re^Gvs, Re^Gvs, Rd, Ce, Gg, Gg, Ce, Ce, Ce, Gg^Vh, Gg, Gg^Vh, Gg
Hh, Hh, Mm, Hh, Mm, Hh, Mm, Hh^Vhh, Hh, Re, Ce, 8 Ke, Ce, Re, Re, Re, Rd, Re^Gvs, Re^Gvs, Ww, Ch, Mm, Mm, Mm^Vhh, Ch, Mm^Vhh, Mm^Vhh, Rd, Rd, Ch, Rd, Ch, Rd, Rd, Mm^Vhh, Mm^Vhh, Ch, Mm^Vhh, Mm, Mm, Ch, Ww, Gg^Efm, Rd, Re^Gvs, Re^Gvs, Re^Gvs, Re^Gvs, Re^Gvs, Re^Gvs, Rd, Rd, Ce, Gg, Gg, Ce, Gg^Vh, Ce, Gg, Gg, Gg, Gg
Mm, Mm, Mm, Mm, Mm, Mm, Mm, Mm^Vhh, Mm, Hh^Vhh, Ce, Ce, Ce, Gg, Ce, Re^Gvs, Re^Gvs, Rd, Re^Gvs, Ww, Ch, Mm, Mm, Mm^Vhh, Ch, Ch, Ch, Mm^Vhh, Mm^Vhh, Rd, Rd, Rd, Mm^Vhh, Mm^Vhh, Ch, Ch, Ch, Mm^Vhh, Mm, Mm, Ch, Ww, Gg^Efm, Rd, Re^Gvs, Re^Gvs, Re^Gvs, Re^Gvs, Re^Gvs, Rd, Re^Gvs, Re^Gvs, Ce, Gg^Vh, Gg, Gg, Gg, Gg, Gg, Gg^Vh, Gg, Gg
Mm, Mm, Mm, Mm, Mm, Mm, Mm, Mm, Mm^Vhh, Hh, Hh^Vhh, Gs^Fp, Gs^Fp, Gs^Fp, Ce, Re^Gvs, Re^Gvs, Rd, Rd, Ww, Ch, Mm, Mm, Ch, Ch, 6 Kh, Ch, Ch, Mm^Vhh, Mm^Vhh, Rd, Mm^Vhh, Mm^Vhh, Ch, Ch, 3 Kh, Ch, Ch, Mm, Mm, Ch, Ww, Gg, Rd, Rd, Re^Gvs, Re^Gvs, Re^Gvs, Gg^Efm, Rd, Re^Gvs, Re^Gvs, Gg, Ce, Ce, Gg^Vh, Ce, Gg^Vh, Ce, Gg^Vh, Ce, Ce
Mm, Mm, Mm^Xm, Mm, Mm, Mm, Mm, Mm^Vhh, Mm^Vhh, Mm, Mm, Mm, Mm, Hh, Ce, Re^Gvs, Re^Gvs, Rd, Re^Gvs, Ww, Ch, Mm, Mm, Mm, Mm, Ch, Ch, Mm^Vhh, Mm^Vhh, Mm, Rd, Mm^Vhh, Mm, Mm, Ch, Ch, Mm, Mm, Mm, Mm, Ch, Ww, Re^Gvs, Re^Gvs, Gg, Rd, Rd, Re^Gvs, Re^Gvs, Rd, Re, Re, Re, Gg, Gg, Ce, Re, Ce, Re^Gvs, Ce, Re^Gvs, Re^Gvs
Mm^Xm, Mm^Xm, Mm^Xm, Mm^Xm, Mm, Mm, Mm, Mm, Mm, Mm, Mm^Vhh, Mm^Vhh, Mm, Hh, Gg, Re^Gvs, Re^Gvs, Rd, Re, Ww, Ww, Ch, Ch, Mm, Mm, Mm, Mm, Mm, Mm, Mm, Rd, Mm, Mm, Mm, Mm, Mm, Mm, Mm, Ch, Ch, Ww, Ww, Re^Gvs, Re^Gvs, Re^Gvs, Re^Gvs, Re, Rd, Rd, Rd, Re^Gvs, Re^Gvs, Re^Gvs, Re, Re, Re, Re^Gvs, Re^Gvs, Re^Gvs, Re^Gvs, Re^Gvs, Re^Gvs
Mm^Xm, Mm^Xm, Mm^Xm, Mm^Xm, Mm, Mm, Mm, Mm, Mm, Mm, Mm, Mm, Mm, Hh, Hh, Re^Gvs, Rd, Rd, Gg, Re, Gg, Ww, Ww, Ch, Ch, Mm, Mm, Mm, Mm, Mm, Rd, Mm, Mm, Mm, Mm, Mm, Ch, Ch, Ww, Ww, Gg^Efm, Re^Gvs, Re, Re^Gvs, Re^Gvs, Re^Gvs, Re^Gvs, Rd, Gg^Efm, Re^Gvs, Re^Gvs, Re^Gvs, Gg^Efm, Re^Gvs, Re^Gvs, Re, Re, Re^Gvs, Re^Gvs, Re^Gvs, Re^Gvs, Re^Gvs
Mm^Xm, Mm^Xm, Mm^Xm, Mm^Xm, Mm, Mm, Mm, Mm, Mm, Mm, Hh, Mm, Hh, Hh, Rd, Rd, Re^Gvs, Gg, Re^Gvs, Gg, Re^Gvs, Re^Gvs, Ww, Ww, Ww, Ch, Ch, Mm, Ch, Mm, Rd, Mm, Ch, Mm, Ch, Ch, Ww, Ww, Re^Gvs, Re^Gvs, Re, Gg^Efm, Re^Gvs, Re^Gvs, Re^Gvs, Re^Gvs, Rd, Rd, Re^Gvs, Re^Gvs, Gg^Efm, Re^Gvs, Gg^Efm, Re^Gvs, Gg, Gg, Re, Re, Re^Gvs, Re^Gvs, Re^Gvs, Re^Gvs
Mm^Xm, Mm^Xm, Mm^Xm, Mm^Xm, Mm, Mm, Mm, Mm, Mm, Mm, Hh, Hh, Gs^Fp, Gg, Rd, Re^Gvs, Hh, Re^Gvs, Re^Gvs, Re^Gvs, Re^Gvs, Re^Gvs, Ww, Ww, Re^Gvs, Ww, Ww, Ch, Ww, Ch, Ww^Bw|, Ch, Ww, Ch, Ww, Ww, Rd, Re^Gvs, Rd, Rd, Rd, Re, Rd, Re^Gvs, Rd, Rd, Gg, Re, Re, Re^Gvs, Re^Gvs, Re^Gvs, Re^Gvs, Gg, Re^Gvs, Re^Gvs, Re, Re^Gvs, Re, Re^Gvs, Re^Gvs, Re^Gvs
Mm^Xm, Mm^Xm, Mm^Xm, Mm^Xm, Mm, Mm, Mm, Mm, Mm, Hh, Hh, Hh, Gs^Fp, Gg, Rd, Re^Gvs, Re^Gvs, Re^Gvs, Ww, Ww, Ww, Ww, Re^Gvs, Re^Gvs, Re, Gg, Gg, Ww, Re^Gvs, Ww, Rd, Ww, Re^Gvs, Ww, Re^Gvs, Rd, Re^Gvs, Rd, Re^Gvs, Re^Gvs, Re^Gvs, Rd, Re^Gvs, Rd, Re^Gvs, Re, Re^Gvs, Re^Gvs, Re^Gvs, Re, Re, Gg, Re^Gvs, Re^Gvs, Re^Gvs, Re^Gvs, Re, Gg, Gg^Efm, Re, Re, Re
Mm^Xm, Mm^Xm, Mm, Mm, Mm, Mm, Mm, Mm, Mm, Mm, Mm, Gg, Gg, Gg, Rd, Re^Gvs, Re^Gvs, Re^Gvs, Ww, Gg, Re^Gvs, Re^Gvs, Re^Gvs, Re^Gvs, Re, Re^Gvs, Re^Gvs, Re^Gvs, Re^Gvs, Re^Gvs, Rd, Re^Gvs, Re^Gvs, Re^Gvs, Re, Re, Re^Gvs, Re^Gvs, Gs^Fp, Re^Gvs, Gs^Fp, Gg, Re^Gvs, Re^Gvs, Re^Gvs, Re, Re^Gvs, Re^Gvs, Re^Gvs, Re^Gvs, Re^Gvs, Re, Re, Re^Gvs, Re, Re^Gvs, Gg, Gg, Gg, Gg, Gg, Gg
Mm, Mm, Mm, Mm, Mm, Mm, Mm, Mm, Hh, Mm, Re^Gvs, Gg, Re^Gvs, Gg, Re, Rd, Rd, Ww, Ww, Re, Re^Gvs, Re^Gvs, Re^Gvs, Re^Gvs, Re, Re^Gvs, Re^Gvs, Re^Gvs, Re^Gvs, Re^Gvs, Rd, Re^Gvs, Re^Gvs, Rd, Re^Gvs, Re^Gvs, Re^Gvs, Re^Gvs, Gs^Fp, Gs^Fp, Gs^Fp, Gs^Fp, Gg, Re^Gvs, Re^Gvs, Re, Re^Gvs, Re^Gvs, Re^Gvs, Re^Gvs, Re^Gvs, Gg, Gg, Re, Gg, Gg, Gg, Gg, Gg, Gg, Gg, Gg
Mm, Mm, Mm, Mm, Hh, Hh, Hh, Hh, Hh, Re^Gvs, Re^Gvs, Re^Gvs, Re, Re, Gg, Gg, Gg, Ww^Bw\, Rd, Re^Gvs, Re^Gvs, Re, Rd, Re^Gvs, Gg, Re^Gvs, Re, Re^Gvs, Re^Gvs, Re, Rd, Re^Gvs, Re^Gvs, Rd, Gs^Fp, Gs^Fp, Gs^Fp, Gs^Fp, Gs^Fp, Gs^Fp, Gs^Fp, Gs^Fp, Gg, Gg^Efm, Re^Gvs, Re, Re, Gg, Re^Gvs, Re^Gvs, Re^Gvs, Gg, Gg, Gg, Gs^Fp, Gg, Gs^Fp, Gs^Fp, Gs^Fp, Gg, Gg, Gg
Mm, Mm, Mm, Hh, Hh, Hh, Gs^Fp, Gs^Fp, Re^Gvs, Re^Gvs, Re^Gvs, Re, Gs^Fp, Gs^Fp, Gs^Fp, Gs^Fp, Ww, Ww, Re, Rd, Rd, Rd, Re^Gvs, Rd, Rd, Rd, Rd, Re, Rd, Rd, Re, Re^Gvs, Rd, Rd, Gg, Gs^Fp, Gs^Fp, Gg^Fet, Gs^Fp, Gg^Fet, Gs^Fp, Gs^Fp, Gs^Fp, Gg, Gg, Gg^Efm, Gg, Gg, Gg, Gg, Gs^Fp, Gg, Gs^Fp, Gs^Fp, Gs^Fp, Gs^Fp, Hh, Gs^Fp, Hh, Gs^Fp, Gg, Gg
Mm, Mm, Mm, Mm, Mm, Hh, Hh, Gs^Fp, Re^Gvs, Re^Gvs, Re, Gg, Gs^Fp, Gg^Fet, Ww, Ww, Gs^Fp, Gs^Fp, Gg, Re, Gg, Re^Gvs, Gs^Fp, Gs^Fp, Gs^Fp, Gs^Fp, Gs^Fp, Rd, Gs^Fp, Gs^Fp, Gs^Fp, Re, Gg^Efm, Gg^Efm, Gg, Gg, Gs^Fp, Gs^Fp, Gs^Fp, Gs^Fp, Gs^Fp, Gs^Fp, Gs^Fp, Gs^Fp, Gg, Gg, Gg, Gg, Gg, Gg, Gs^Fp, Gs^Fp, Gs^Fp, Hh, Hh, Hh, Hh, Gs^Fp, Hh, Hh, Gg, Gg
Mm, Mm, Mm, Mm, Mm, Hh, Hh, Hh, Hh, Re^Gvs, Re^Gvs, Re, Ww, Ww, Gs^Fp, Gs^Fp, Gg^Fet, Gs^Fp, Gg, Gg, Gs^Fp, Gs^Fp, Gs^Fp, Gs^Fp, Hh, Hh, Hh, Gs^Fp, Gs^Fp, Gs^Fp, Gs^Fp, Gg, Gg, Gg, Gs^Fp, Gs^Fp, Gs^Fp, Gs^Fp, Gs^Fp, Gs^Fp, Gs^Fp, Gs^Fp, Gs^Fp, Gs^Fp, Gg, Gg, Gg, Gg, Gg, Gs^Fp, Gs^Fp, Hh, Hh, Hh, Hh, Hh, Hh, Hh, Hh, Gg, Gg, Gg
Mm, Mm, Ww, Mm, Mm, Mm, Mm, Mm, Mm, Hh, Re^Gvs, Re^Gvs, Ww, Gs^Fp, Gg, Gs^Fp, Gs^Fp, Gs^Fp, Gg, Gs^Fp, Gg, Gg^Fet, Hh, Hh, Hh, Hh, Hh, Hh, Hh, Gs^Fp, Gs^Fp, Gs^Fp, Gs^Fp, Gg^Efm, Gg^Efm, Gs^Fp, Gs^Fp, Gg^Fet, Gs^Fp, Gs^Fp, Gs^Fp, Gg^Fet, Gs^Fp, Gs^Fp, Gg, Gg, Gg, Gg, Gs^Fp, Gs^Fp, Gs^Fp, Hh, Gs^Fp, Hh, Gs^Fp, Gs^Fp, Hh, Hh, Gs^Fp, Gs^Fp, Gs^Fp, Gs^Fp
Ww, Ww, Mm, Ww, Mm, Mm, Mm, Mm, Mm, Mm, Gg, Gg, Ww, Gg, Gg^Efm, Gg^Efm, Gs^Fp, Gg, Gg, Gs^Fp, Gs^Fp, Gs^Fp, Gs^Fp, Gs^Fp, Hh, Hh, Hh, Hh, Hh, Gs^Fp, Gg^Fet, Gs^Fp, Gs^Fp, Gs^Fp, Gg^Efm, Gs^Fp, Gs^Fp, Gs^Fp, Gg^Efm, Gg, Gs^Fp, Gs^Fp, Gs^Fp, Gg, Gg, Gg, Gg, Gg, Gg, Gs^Fp, Gs^Fp, Gs^Fp, Gs^Fp, Gs^Fp, Gs^Fp, Gs^Fp, Hh, Gg, Gs^Fp, Gs^Fp, Gg, Gg
Mm, Mm, Mm, Ww, Mm, Mm, Mm, Mm, Mm, Mm, Hh, Hh, Ww, Gg^Efm, Gg, Gg, Gs^Fp, Gs^Fp, Gs^Fp, Gs^Fp, Gs^Fp, Gs^Fp, Gg^Fet, Gs^Fp, Gs^Fp, Hh, Gs^Fp, Hh, Hh, Gs^Fp, Gs^Fp, Gs^Fp, Gg^Fet, Gs^Fp, Gs^Fp, Gg^Efm, Gg^Efm, Gg^Efm, Gs^Fp, Gg^Efm, Gg^Efm, Gs^Fp, Gg, Gs^Fp, Gs^Fp, Gs^Fp, Gs^Fp, Gg, Gg, Gs^Fp, Gs^Fp, Gs^Fp, Gs^Fp, Gs^Fp, Gs^Fp, Gs^Fp, Gs^Fp, Gs^Fp, Gs^Fp, Gg, Gg, Gg
Mm, Mm, Mm, Ww, Ww, Mm, Mm, Mm, Mm, Mm, Ww, Ww, Gg^Efm, Gg^Efm, Gs^Fp, Gs^Fp, Gs^Fp, Gs^Fp, Gs^Fp, Gg^Fet, Gs^Fp, Gs^Fp, Gs^Fp, Gs^Fp, Gs^Fp, Gs^Fp, Gs^Fp, Gs^Fp, Gs^Fp, Gs^Fp, Gs^Fp, Gs^Fp, Gs^Fp, Gs^Fp, Gs^Fp, Gs^Fp, Gg^Efm, Gs^Fp, Gs^Fp, Gg, Gg, Gg^Efm, Gs^Fp, Gg^Fet, Hh, Gs^Fp, Gs^Fp, Gg, Gg, Gs^Fp, Gs^Fp, Gs^Fp, Gs^Fp, Gs^Fp, Gs^Fp, Gs^Fp, Gg, Gs^Fp, Gg, Gg, Gg, Gg
Mm, Mm, Mm, Mm, Mm, Ww, Ww, Mm, Mm, Hh, Ww, Gg, Gs^Fp, Gg, Gg^Fet, Gs^Fp, Gs^Fp, Gg^Fet, Gs^Fp, Gs^Fp, Hh, Gs^Fp, Gs^Fp, Gs^Fp, Gs^Fp, Gg^Ve, Gs^Fp, Gs^Fp, Gg^Ve, Gs^Fp, Gg^Efm, Gg^Ve, Gs^Fp, Gg^Efm, Gg^Efm, Gg^Ve, Gs^Fp, Gs^Fp, Hh, Hh, Hh, Gs^Fp, Hh, Gs^Fp, Hh, Hh, Gs^Fp, Gs^Fp, Gs^Fp, Gg, Gs^Fp, Gs^Fp, Gs^Fp, Gs^Fp, Gg, Gs^Fp, Gg, Gg, Gg, Gg, Gg, Gg
Mm, Mm, Mm, Mm, Mm, Mm, Hh, Ww, Hh, Hh, Ww, Gs^Fp, Gs^Fp, Gs^Fp, Gs^Fp, Gs^Fp, Hh, Gs^Fp, Hh, Hh, Hh, Hh, Hh, Gg^Ve, Gs^Fp, Gg, Gg^Efm, Gg^Efm, Gg^Efm, Gg^Efm, Gg^Efm, Gg^Efm, Gg, Gs^Fp, Gg^Efm, Gg^Efm, Gs^Fp, Gg^Fet, Gs^Fp, Hh, Hh, Hh, Hh, Hh, Hh, Hh, Gs^Fp, Gs^Fp, Gs^Fp, Gg, Gg, Gs^Fp, Gg, Gg, Gg, Gg, Gs^Fp, Gs^Fp, Gs^Fp, Gs^Fp, Gs^Fp, Gs^Fp
Mm, Mm, Mm, Mm, Mm, Hh, Ww, Ww, Ww, Ww, Gg, Gs^Fp, Gg^Fet, Gs^Fp, Gs^Fp, Gs^Fp, Gg, Hh, Hh, Hh, Gs^Fp, Hh, Gs^Fp, Gg^Efm, Gg^Efm, Gg^Ve, Gg, Gg^Efm, Gg^Efm, Ce, Ce, Ce, Ce, Ce, Gg^Efm, Gg^Efm, Gs^Fp, Gs^Fp, Gg^Ve, Gg^Ve, Hh, Hh, Hh, Hh, Gs^Fp, Gs^Fp, Gs^Fp, Gs^Fp, Gs^Fp, Gg, Gg, Gs^Fp, Gg, Gg, Gg, Gg, Gs^Fp, Gs^Fp, Gs^Fp, Gs^Fp, Gs^Fp, Gs^Fp
Mm, Mm, Mm, Mm, Mm, Hh, Ww, Ww, Gg^Fet, Gg, Gg, Gg, Gs^Fp, Gs^Fp, Gs^Fp, Gg, Gs^Fp, Gs^Fp, Hh, Gs^Fp, Gs^Fp, Gg^Fet, Gs^Fp, Gs^Fp, Gg^Efm, Gg^Efm, Gg^Ve, Gg^Efm, Gg, Ce, Ce, 9 Ke, Ce, Ce, Gg^Efm, Gg^Ve, Gs^Fp, Gs^Fp, Hh, Hh, Gs^Fp, Hh, Gs^Fp, Hh, Gs^Fp, Gs^Fp, Gs^Fp, Gs^Fp, Gg^Fet, Gs^Fp, Gs^Fp, Gg, Gs^Fp, Gs^Fp, Gs^Fp, Gs^Fp, Gs^Fp, Gs^Fp, Gs^Fp, Gs^Fp, Gs^Fp, Gs^Fp
Mm, Mm, Mm, Mm, Mm, Ww, Ww, Gg^Fet, Gs^Fp, Gs^Fp, Gg, Gg^Efm, Gs^Fp, Gs^Fp, Gs^Fp, Gs^Fp, Gs^Fp, Gs^Fp, Gs^Fp, Gs^Fp, Gs^Fp, Gs^Fp, Gg^Ve, Gs^Fp, Gg^Ve, Gg^Efm, Gg^Efm, Gg^Efm, Gg^Efm, Ce, Gg^Ve, Ce, Gg^Ve, Ce, Gg^Efm, Gs^Fp, Gs^Fp, Gs^Fp, Hh, Gs^Fp, Gs^Fp, Gs^Fp, Gs^Fp, Gs^Fp, Gg, Gs^Fp, Gs^Fp, Gs^Fp, Gs^Fp, Gs^Fp, Gs^Fp, Gg, Gs^Fp, Gs^Fp, Gs^Fp, Gs^Fp, Gs^Fp, Gs^Fp, Gs^Fp, Gs^Fp, Gg, Gg
Mm, Mm, Mm, Mm, Mm, Ww, Gg, Gs^Fp, Gs^Fp, Gs^Fp, Gg^Efm, Gg^Efm, Gg, Gs^Fp, Gg^Fet, Gs^Fp, Gs^Fp, Gs^Fp, Gs^Fp, Gg^Fet, Gs^Fp, Gs^Fp, Gs^Fp, Gs^Fp, Gs^Fp, Gg^Efm, Gs^Fp, Gs^Fp, Gs^Fp, Gs^Fp, Gs^Fp, Gg^Efm, Gg^Efm, Gg^Efm, Gg^Efm, Gs^Fp, Gs^Fp, Gs^Fp, Gs^Fp, Gs^Fp, Gs^Fp, Gs^Fp, Gs^Fp, Gs^Fp, Gs^Fp, Gg^Fet, Gs^Fp, Gs^Fp, Gs^Fp, Gs^Fp, Gs^Fp, Gs^Fp, Gg, Gs^Fp, Gs^Fp, Gs^Fp, Gs^Fp, Gs^Fp, Hh, Hh, Hh, Hh
Hh, Hh, Hh, Mm, Ww, Ww, Gg, Gs^Fp, Gs^Fp, Gs^Fp, Gg^Efm, Gg, Gs^Fp, Gs^Fp, Gs^Fp, Gs^Fp, Gs^Fp, Gg^Fet, Gs^Fp, Gs^Fp, Gs^Fp, Gg^Fet, Gs^Fp, Gs^Fp, Gg^Ve, Gs^Fp, Gs^Fp, Gg^Ve, Gs^Fp, Gs^Fp, Gg^Ve, Gs^Fp, Gg^Fet, Gg^Ve, Gg^Efm, Gg, Gs^Fp, Gg^Ve, Gs^Fp, Gs^Fp, Gg^Fet, Gs^Fp, Gg^Fet, Gs^Fp, Gs^Fp, Gs^Fp, Gs^Fp, Gs^Fp, Gg^Fet, Gs^Fp, Gs^Fp, Gs^Fp, Gs^Fp, Gg, Gs^Fp, Gs^Fp, Hh, Hh, Hh, Hh, Hh, Hh
Hh, Hh, Hh, Ww, Gs^Fp, Gg^Fet, Gs^Fp, Gg, Gg, Gg, Gg, Gs^Fp, Gs^Fp, Gs^Fp, Gs^Fp, Gs^Fp, Gg^Fet, Gs^Fp, Gs^Fp, Hh, Hh, Hh, Gs^Fp, Gs^Fp, Gs^Fp, Gs^Fp, Gg^Ve, Gs^Fp, Gs^Fp, Gs^Fp, Hh, Gs^Fp, Gs^Fp, Gg^Efm, Gg, Gg, Gs^Fp, Gs^Fp, Gs^Fp, Gs^Fp, Gs^Fp, Gs^Fp, Gs^Fp, Gs^Fp, Gs^Fp, Gs^Fp, Gs^Fp, Gs^Fp, Gs^Fp, Gg^Fet, Gs^Fp, Gs^Fp, Gs^Fp, Gs^Fp, Gs^Fp, Hh, Hh, Hh, Mm, Hh, Mm, Mm
Hh, Hh, Ww, Ww, Gs^Fp, Gs^Fp, Gs^Fp, Gg, Gg, Gg, Gs^Fp, Gs^Fp, Gs^Fp, Gs^Fp, Gs^Fp, Gs^Fp, Gs^Fp, Gs^Fp, Hh, Hh, Hh, Gs^Fp, Hh, Gs^Fp, Gs^Fp, Gs^Fp, Hh, Hh, Hh, Hh, Hh, Gs^Fp, Hh, Gg, Gg, Gs^Fp, Gg, Gs^Fp, Gs^Fp, Gs^Fp, Gs^Fp, Gs^Fp, Gs^Fp, Gs^Fp, Gg^Fet, Gs^Fp, Gs^Fp, Gs^Fp, Gs^Fp, Gs^Fp, Gs^Fp, Gs^Fp, Gs^Fp, Gg, Gs^Fp, Hh, Hh, Hh, Mm, Mm, Mm, Mm
Ww, Ww, Gs^Fp, Gs^Fp, Gs^Fp, Gs^Fp, Gg, Gg, Gg, Gs^Fp, Gs^Fp, Gs^Fp, Gs^Fp, Gs^Fp, Gs^Fp, Gs^Fp, Gs^Fp, Hh, Hh, Hh, Hh, Hh, Hh, Hh, Hh, Hh, Hh, Hh, Hh, Hh, Hh, Hh, Gs^Fp, Gg, Gg, Gg, Gs^Fp, Gs^Fp, Gs^Fp, Gg^Fet, Gs^Fp, Gs^Fp, Gs^Fp, Gs^Fp, Gs^Fp, Gs^Fp, Gs^Fp, Gs^Fp, Gs^Fp, Gs^Fp, Gs^Fp, Gs^Fp, Gs^Fp, Gg, Hh, Gs^Fp, Hh, Hh, Mm, Mm, Mm, Mm
Ww, Ww, Gs^Fp, Gs^Fp, Gs^Fp, Gs^Fp, Gg, Gg, Gg, Gs^Fp, Gs^Fp, Gs^Fp, Gs^Fp, Gs^Fp, Gs^Fp, Gs^Fp, Gs^Fp, Hh, Hh, Hh, Hh, Hh, Hh, Hh, Hh, Hh, Hh, Hh, Hh, Hh, Hh, Hh, Gs^Fp, Gg, Gg, Gg, Gs^Fp, Gs^Fp, Gs^Fp, Gs^Fp, Gs^Fp, Gs^Fp, Gs^Fp, Gs^Fp, Gs^Fp, Gs^Fp, Gs^Fp, Gs^Fp, Gs^Fp, Gs^Fp, Gs^Fp, Gs^Fp, Gs^Fp, Gg, Hh, Gs^Fp, Hh, Hh, Mm, Mm, Mm, Mm
