border_size=1
usage=map

Gll^Fp, Gll^Fp, Gll^Fp, Gll^Fp, Rb, Rb, Rb, Gg, Hh, Hh, Hh, Mm, Mm, Mm, Mm, Mm, Mm, Mm, Mm, Mm, Mm, Mm, Mm, Mm, Mm, Mm, Mm, Mm, Hh, Hh, Gg, Gg, Gll^Fp, Gll^Fp, Gg, Gg, Gg, Gg, Mm, Mm, Mm, Mm, Mm, Ww, Ww, Mm, Mm, Mm, Mm, Mm, Mm, Ww, Ww, Gll^Fp, Gll^Fp, Gll^Fp, Re, Gg, Gg, Gg, Gg, Gg
Gg, Gll^Fp, Gll^Fp, Gll^Fp, Re, Rb, Re, Gg, Gg, Hh, Hh, Mm, Mm, Mm, Mm, Mm, Hh^Vhh, Mm, Mm, Mm, Mm, Mm, Mm, Mm, Mm, Mm, Mm, Mm, Hh, Hh, Gg^Fet, Gll^Fp, Gll^Fp, Gll^Fp, Gll^Fp, Gs, Gs, Gs, Mm, Mm, Mm, Mm, Mm, Ww, Wwf, Mm, Mm, Hh, Hh, Mm, Ww, Ww, Gll^Fp, Gll^Fp, Gll^Fp, Re, Re^Vct, Re, Re, Gg, Gg, Gg
Rb, Gg, Rb, Re, Re, Re^Vct, Re, Re^Vct, Rb, Hh^Vhh, Rb, Gg, Gg, Mm, Mm, Mm, Hh^Fp, Mm, Mm, Mm, Mm, Mm, Gs^Vh, Gg, Gg, Gg, Gg, Hh, Hh^Fp, Hh^Fp, Gg, Gg, Gg, Gll^Fp, Gll^Fp, Gg, Gs^Vh, Gg, Gs, Mm, Mm, Mm, Mm, Mm, Ww, Ww, Hh, Hh, Hh, Mm, Wo, Ww, Gll^Fp, Gll^Fp, Gg, Gg, Re, Re, Gll^Fp, Gg, Gll^Fp, Gg
Gg, Rb, Gg, Re, Gll^Fp, Re, Re, Re, Re, Rb, Re, Re^Vct, Rb, Gg, Gll^Fp, Hh^Fp, Hh^Fp, Mm, Mm, Mm, Mm, Mm, Gg, Gg, Gg, Gg, Gg, Gg, Hh^Fp, Hh, Hh, Gg, Gg, Gll^Fp, Gll^Fp, Gll^Fp, Gs, Gs, Gg, Gs, Gll^Fp, Mm, Mm, Mm, Ww, Ww, Ww, Hh^Vhh, Hh^Fp, Mm, Ww, Ww, Gg, Gll^Fp, Gg, Gs^Vh, Re, Re, Gll^Fp, Gll^Fp, Gll^Fp, Gll^Fp
Mm, Gg, Mm, Gll^Fp, Gll^Fp, Re, Re^Vct, Re, Gg, Re, Re, Re, Rb, Ce, Ce, Hh, Hh, Mm, Mm, Mm, Mm, Mm, Gg, Gg, Gd, Gs, Gs, Gg, Gg, Hh, Hh, Gg, Gs^Vl, Gll^Fp, Gll^Fp, Gll^Fp, Gg, Gs, Gg^Efm, Gg, Gll^Fp, Gll^Fp, Gg, Mm, Mm, Ww, Ww, Hh, Gll^Fp, Hh^Fp, Ww, Ww, Ce, Gg, Gg, Re, Re^Vct, Re, Gg, Gg, Gll^Fp, Gll^Fp
Mm, Mm, Mm, Mm, Mm, Gll^Fp, Mm, Gg, Hh^Fp, Rb, Rb, Re, Ce, Ce, Ce, Hh, Gg, Gg, Gg, Gg, Gg, Gg, Gg, Gg, Gs, Gd^Vo, Gll^Fp, Gg, Gll^Fp, Gg, Mm, Mm, Mm, Gg, Gg, Gll^Fp, Gll^Fp, Gg, Gg^Efm, Gg, Gg, Gll^Fp, Gll^Fp, Gg, Gg, Gs, Gg, Ww, Ww, Ww, Ww, Ce, Ce, Gg, Ce, Re, Re, Re, Gs^Vh, Gg, Gg, Gll^Fp
Mm, Mm, Mm, Mm, Mm, Mm, Mm, Mm, Hh, Hh, Gg, Gg, Ce, 3 Ke, Ce, Ce, Gg, Gg, Gg, Gg, Gg, Gg^Efm, Gg, Gg, Gg, Gs, Gll^Fp, Gll^Fp, Gll^Fp, Gg, Gg, Mm, Gd, Gd, Gd, Gg, Gg, Gg, Gg, Gll^Fp, Gll^Fp, Gg, Gg, Hh^Fp, Gs, Gg, Gs^Vc, Gg, Ds, Ww, Ww, Ce, Ce, 2 Ke, Ce, Ce, Re, Gg, Re, Gg, Gg, Gg
Mm, Mm, Mm, Mm, Mm, Mm, Mm, Mm, Mm, Hh^Vhh, Gg, Ce, Ce, Ce, Re, Ce, Gg, Gg, Gg, Gg, Mm, Gg, Mm, Mm, Mm, Gg, Gll^Fp, Gll^Fp, Gg, Gg, Gg, Gg, Gg, Gg, Gg, Gd, Gd, Gg, Gg, Gg, Gs^Vl, Gll^Fp, Gll^Fp, Gll^Fp, Gg, Gg, Gg, Ds, Ww, Ww, Ww, Ww, Ce, Ce, Ds, Ce, Re, Re, Re, Re, Gg, Gg
Mm, Mm, Mm, Mm, Mm, Mm, Mm, Mm, Mm, Mm, Mm, Gg, Gg, Gg, Re, Gg, Gg, Gg, Mm, Mm, Mm, Mm, Mm, Mm, Mm, Hh^Fp, Hh, Gll^Fp, Gg, Gg, Gg, Gg, Gg, Gg, Gg^Efm, Gd, Gd, Gg, Gg, Gg, Gll^Fp, Gll^Fp, Gg, Gg, Gg, Gg, Gg, Ds, Ds, Ww, Ww, Ww, Wwrg, Ce, Ww, Ds, Ds, Ds, Gg, Gs^Vh, Gg, Gg
Mm, Mm, Mm, Mm, Mm, Gll^Fp, Gg, Mm, Mm, Mm, Mm, Gg, Gd, Gd, Re, Gg, Gg, Hh, Mm, Mm, Mm, Mm, Mm, Mm, Gg, Hh, Gg, Gg, Gg, Gg, Gd^Vo, Gg, Gg, Gg, Gg, Gd, Gd, Gg, Gg, Gg, Gll^Fp, Gll^Fp, Gg, Gg, Gg, Gg^Efm, Gg, Gg, Ds, Ww, Ww, Ww, Wwrg, Wwrg, Ww, Ww, Ww, Ds, Gg, Gg^Efm, Gg, Gg
Mm, Mm, Gll^Fp, Mm, Gll^Fp, Gll^Fp, Gd, Ds, Ds, Mm, Ds, Gd, Gd, Re, Gll^Fp, Gd, Gll^Fp, Hh^Fp, Mm, Mm, Mm, Mm, Hh, Gg, Gg, Gg, Gg, Gg, Gg, Gg, Gd, Gd, Gd, Gd, Gg, Gg, Gd, Gg, Gg, Gg, Gg, Gg, Gg, Gg, Gg, Gg^Efm, Gg^Efm, Gg, Gg, Ds, Gg, Wwrg, Wwrg, Wwrg, Ww, Ww, Ww, Ww, Gll^Fp, Gg, Gg, Gg
Mm, Mm, Mm, Gll^Fp, Gll^Fp, Gll^Fp, Gll^Fp, Gd, Ds, Ds, Ds^Vct, Ds, Ds, Rd, Gll^Fp, Gll^Fp, Gll^Fp, Hh^Fp, Hh, Mm, Gg, Hh, Gg, Gg, Gg, Gg, Gg, Gg, Gg, Gg, Gg, Gg, Gg, Gg, Gll^Fp, Gg, Gs^Vh, Gd, Gd, Gg, Rb^Gvs, Rb^Gvs, Rb^Gvs, Gg, Gs^Vc, Gg, Gg, Gg, Gg, Gg, Gg, Gg, Gg, Gg, Ww, Ww, Ww, Ww, Gll^Fp, Gll^Fp, Gll^Fp, Gg
Mm, Mm, Mm, Gg, Gg, Gg, Gll^Fp, Gll^Fp, Rd, Ds, Ds, Ds, Ds, Ds, Gll^Fp, Gll^Fp, Gll^Fp, Gg, Gg, Gg, Gg, Hh^Vhh, Gll^Fp, Gg, Gs, Gg, Gg, Gg, Gll^Fp, Gll^Fp, Gll^Fp, Gll^Fp, Gll^Fp, Gll^Fp, Gll^Fp, Gll^Fp, Gg, Gg, Rb^Gvs, Rb^Gvs, Rb^Gvs, Rb^Gvs, Rb^Gvs, Rb^Gvs, Rb^Gvs, Gg, Gg, Gg, Gg, Gg, Gg, Gg, Gg, Gg, Ww, Ww, Gll^Fp, Gll^Fp, Gll^Fp, Gll^Fp, Gll^Fp, Gll^Fp
Mm, Mm, Gg, Gg, Gd^Vo, Gg, Gg, Gll^Fp, Rd, Ds, Ds, Ds, Ds, Gll^Fp, Ds, Gll^Fp, Gd, Gg, Gg, Gg, Gs, Gg, Gs, Gs, Gg, Gg, Gg, Gll^Fp, Gg, Gg, Gs^Vl, Gll^Fp, Gll^Fp, Gll^Fp, Gg, Gg, Gg, Rb^Gvs, Rb^Gvs, Rb^Gvs, Rb^Gvs, Rb^Gvs, Rb^Gvs, Rb^Gvs, Gg, Gg, Gg, Gg, Gg, Gg, Gg, Gg, Gg, Ww, Ww, Gg, Gll^Fp, Gll^Fp, Gg, Gll^Fp, Gll^Fp, Gll^Fp
Mm, Mm, Mm, Gg, Gg, Gg, Gg, Gg, Rd, Rd, Ds, Ds, Ds, Ds, Ds, Gd, Gg, Gg, Gs, Gs, Gs, Gs, Gg, Gg, Gg, Gg, Gll^Fp, Gll^Fp, Gg, Gg, Gg, Gll^Fp, Gg, Gg, Rb^Gvs, Gg, Gg, Gg, Gg, Rb^Gvs, Rb^Gvs, Rb^Gvs, Gg, Gg, Gg, Gg, Ww, Ww, Ww, Ww, Ww, Gg, Gg, Ww, Ww, Gg, Gg, Gg, Gg, Gg, Gg, Gg
Mm, Mm, Mm, Gg, Gg, Gg, Gll^Fp, Gg, Gg, Rd, Rd, Ds, Ds, Ds, Rd, Rd, Re, Gg, Gs, Gg, Gg, Gg, Gg, Gg, Gg, Gg, Gg, Gg, Gg, Gg, Gg, Gg, Rb^Gvs, Rb^Gvs, Rb^Gvs, Rb^Gvs, Rb^Gvs, Gg, Gs^Vh, Gg, Gg, Gg, Gg, Gg, Wwf, Wwf, Ww, Ww, Ww, Ww, Ww, Wo, Wo, Wo, Ww, Gg, Gg^Efm, Gg, Gg, Gs^Vc, Gg, Gg
Mm, Mm, Mm, Mm, Mm, Gll^Fp, Gll^Fp, Gll^Fp, Gll^Fp, Gg, Gg, Gs, Gs, Rd, Gs, Gs, Re, Re, Gs, Gg, Gll^Fp, Gg, Gd^Vo, Gll^Fp, Gg, Gg, Gg, Gg, Gll^Fp, Gg, Rb^Gvs, Rb^Gvs, Rb^Gvs, Rb^Gvs, Rb^Gvs, Rb^Gvs, Rb^Gvs, Rb^Gvs, Rb^Gvs, Gg, Gg, Gg, Wwf, Wwf, Wwf, Wwf, Gg, Gg, Gg, Gg, Gg, Wo, Wo, Wo, Gg, Gg, Gg, Gg, Gg, Gg, Gg, Gg
Mm, Mm, Mm, Mm, Mm, Hh, Hh^Fp, Gll^Fp, Gg, Gg, Gg, Gg, Gg, Gs, Gg, Re, Re, Re, Gs, Gg, Gg, Gll^Fp, Gll^Fp, Gll^Fp, Gll^Fp, Gll^Fp, Gll^Fp, Gll^Fp, Gg, Gg, Gg, Rb^Gvs, Rb^Gvs, Rb^Gvs, Rb^Gvs, Rb^Gvs, Rb^Gvs, Rb^Gvs, Rb^Gvs, Rb^Gvs, Gg, Gg, Wwf, Wwf, Gg, Gg, Gg, Gg, Gg, Gg, Gg, Gg, Gg, Gg, Re, Re, Gg, Gd, Gg, Gg, Gg, Gg
Mm, Mm, Mm, Mm, Hh, Hh^Fp, Hh, Gll^Fp, Gg, Gg, Gg, Gg, Gg, Gs, Gs, Gs, Re, Re, Re, Gg, Gg, Gll^Fp, Gg, Gg, Gg, Gg, Gg, Gg, Gg, Gg, Gg, Gg, Gd, Rb^Gvs, Rb^Gvs, Rb^Gvs, Rb^Gvs, Rb^Gvs, Gg, Gg, Gg, Gg, Ww, Wwf, Gg, Gg, Gg, Gg, Gg, Gg, Gg, Gg, Re, Re, Gg, Gg, Gd, Gd, Rb^Gvs, Gg, Gg, Gg
Mm, Mm, Mm, Hh, Hh, Hh, Gg, Gg, Gg, Gg, Gs, Gg, Gg, Gg, Gg, Gg, Re, Re, Re, Gg, Gs, Gg, Gg, Gg, Gg, Gg, Gd, Gd, Gd, Gd, Gd, Gd^Vo, Gd, Gd, Gd, Rb^Gvs, Gg, Gg, Gg, Gg, Gd^Vo, Gs, Ww, Ww, Gg, Gg, Gg, Gg, Gg, Gd^Vo, Gd, Gg, Gd, Gg, Gd^Vo, Gg, Rb^Gvs, Rb^Gvs, Rb^Gvs, Rb^Gvs, Rb^Gvs, Gg
Mm, Mm, Hh, Hh^Vhh, Gg, Gg, Gg, Gg, Gs, Gs^Vh, Gs, Gs, Gs, Gs, Gg, Gg, Re, Re, Gs, Gs, Gg, Gg, Gg, Gg, Gg, Gg, Gg, Gg, Gg, Gg, Gg, Gg, Gg, Gg, Gg, Gg, Gg, Gg, Gg, Gs, Gs, Gs, Ww, Ww, Gg, Gg, Gg, Gd, Gd, Gd, Gg, Gd, Gg, Gd, Gll^Fp, Rb^Gvs, Rb^Gvs, Rb^Gvs, Rb^Gvs, Rb^Gvs, Rb^Gvs, Rb^Gvs
Mm, Mm, Mm, Gg, Gg, Gg, Gg, Gs, Gg, Gs, Gg, Gg, Gg, Gs^Vh, Gg, Gg, Re, Re, Re, Gd^Vo, Gg, Gg, Gg, Gg, Gg, Gg, Gg, Gg, Gg, Gg, Gg, Gg, Gg, Gg, Gg, Gg, Gg, Gg, Gg, Gs, Gg, Gg, Ww, Ww, Gg, Gg, Gg, Gd, Gd, Gd, Gd, Gg, Gll^Fp, Gll^Fp, Gll^Fp, Gll^Fp, Gg, Rb^Gvs, Rb^Gvs, Rb^Gvs, Gg, Gg
Mm, Mm, Mm, Gg, Gg, Gg, Gd^Vo, Gg, Gg, Gg, Gll^Fp, Gg, Gg, Gg, Gs, Gg, Gs, Re, Re, Re, Re, Gg, Rd, Gg, Gg, Gg, Gg, Gg, Gg, Gg, Gg, Gg, Ww, Gg, Gg, Gg, Gg, Gg, Gg, Gg, Ww, Ww, Ww, Ww, Gg^Efm, Gg, Gg^Efm, Gg^Efm, Gg, Gg, Gg, Gg, Gll^Fp, Gll^Fp, Gg^Fet, Gg, Gg, Gg, Gg, Gg, Gg, Gg
Mm, Mm, Mm, Gll^Fp, Gll^Fp, Gll^Fp, Gll^Fp, Gll^Fp, Gll^Fp, Gll^Fp, Gg, Gg, Gg, Gg, Gg, Gs, Gg, Gs, Re, Re, Gg, Re, Rd, Gg, Gg, Gg, Gg, Gg, Gg, Gg, Ww, Ww, Ch, Ww, Ww, Gg, Ww, Gg, Ww, Ww, Ww, Ww, Re, Re, Re, Re, Gg, Gg, Gg, Gg, Gg, Gll^Fp, Gll^Fp, Gll^Fp, Gs, Gg, Gg, Gg, Gg, Gg, Gg, Gg
Gll^Fp, Mm, Gll^Fp, Gll^Fp, Gll^Fp, Gll^Fp, Gll^Fp, Gll^Fp, Mm, Gg, Mm, Gg, Gg, Gg, Gg, Gg, Gg, Gg, Re, Re, Gg, Rd, Rd, Rd, Re, Gg, Gg, Gg, Ww, Ww, Ch, Ch, 7 Kh, Ch, Ch, Ww, Mm, Ww, Xu, Ww, Gg, Gg, Re, Re, Re, Re, Gg, Gg, Gg, Gg, Gs, Gll^Fp, Gs^Vh, Gs, Gg, Gg, Gg, Gs^Vl, Gg, Gg^Efm, Gg, Gg
Gll^Fp, Gll^Fp, Gll^Fp, Gll^Fp, Gll^Fp, Gll^Fp, Mm, Mm, Mm^Xm, Mm, Mm, Mm, Gg, Gg, Gg, Gg, Gg, Gg, Gg, Re, Re, Gg, Gg, Gg, Gg, Re, Ww^Bsb\, Ww, Xu, Ch, Ch, Ch, Ch, Ch, Ch, Ch, Xu, Xu, Cud, Ww, Ww^Bsb/, Re, Gg, Gg, Gg, Gg, Gg, Gs^Vl, Gg, Gs, Gg, Gs, Gg, Gg, Gg, Gg, Gg, Gg, Gg, Gg, Gg, Gg
Gll^Fp, Gll^Fp, Mm, Gll^Fp, Mm, Mm, Mm^Xm, Mm^Xm, Mm^Xm, Mm, Gg, Gg, Gg, Gg, Gg, Gs^Vh, Gs, Gg, Gs, Gg, Gg, Re, Re, Gg, Ww, Ww, Cud, Cud, Xu, Xu, Mm, Gs, Gs, Gs, Gs, Xu, Cud, Rr, Rr, Cud, Cud, Ww, Ww, Gg, Gg, Gg, Gg, Gg, Gg, Gs, Gs, Gs, Gs, Gg, Gs, Gg, Gll^Fp, Gll^Fp, Gg, Gg, Gg, Gg
Mm, Mm, Mm^Xm, Mm^Xm, Mm^Xm, Mm^Xm, Mm, Mm, Mm, Mm, Mm, Gg, Gg, Gg, Gg, Gs, Gg, Gs, Gg, Gg, Gg, Gg, Ww, Ww^Bsb\, Cud, Xu, Rr, Xu, Rr^Vhc, Mm, Rp, Rr^Vhc, Rr, Rr^Vhc, Re, Re, Xu, Rr, Rr, Rr, Xu, Xu, Ww, Gg, Gg, Gg, Rb^Gvs, Gg, Gll^Fp, Gg, Gll^Fp, Gs, Gll^Fp, Gs, Gll^Fp, Gll^Fp, Gg^Fet, Gll^Fp, Gg, Gg, Gg, Gg
Mm^Xm, Mm^Xm, Mm, Mm^Xm, Mm, Mm, Hh^Fp, Hh^Fp, Mm, Mm, Mm, Gg, Gg, Gg, Gg, Gs, Gs, Gs, Gg, Gg, Gg, Ww, Xu, Cud, Xu, Rr, Rr, Rr, Rr, Rp, Xos, Gs, Re, Rr, Rr^Vhc, Re, Cud, Rr, Rr, Xu, Xu, Xu, Ww, Gg, Rb^Gvs, Rb^Gvs, Rb^Gvs, Rb^Gvs, Rb^Gvs, Gll^Fp, Gll^Fp, Gll^Fp, Gg, Gll^Fp, Gll^Fp, Gg, Gg, Gs^Vh, Gg, Gg, Gg, Gg
Mm, Mm, Mm, Mm, Gll^Fp, Hh, Gll^Fp, Hh, Gll^Fp, Mm, Mm, Mm, Gg, Gg, Gg, Gs, Gs, Gg, Gg, Gg, Ww, Ww, Wo, Xu, Mm^Xm, Rr^Vhc, Rr, Rr, Xos, Cud, Cud, Cud, Xos, Re, Re, Re, Xuc, Rr, Rr, Xu, Xu, Xu, Ww, Gg, Gg, Rb^Gvs, Rb^Gvs, Rb^Gvs, Gg, Gg, Gg, Gll^Fp, Gll^Fp, Gll^Fp, Gg, Gll^Fp, Gg, Gg, Gg, Gg, Gg, Gg
Mm, Mm, Hh^Fp, Hh^Fp, Hh^Fp, Hh, Gll^Fp, Gll^Fp, Gll^Fp, Gll^Fp, Gll^Fp, Gg, Gg, Gg, Gg, Gs, Gd^Vo, Gg, Gg, Gg, Ww, Ww, Ch, Mm^Xm, Md, Re, Rr, Re, Cud, Cud, 4 Kud, Cud, Cud, Re, Rp^Vhcr, Re, Cud, Rr, Rr, Rr, Cud, Xu, Ww, Gg, Gg, Gg, Gg, Gg, Gg, Gg, Gs, Gs, Gll^Fp, Gll^Fp, Gll^Fp, Gll^Fp, Gg, Gg, Gll^Fp, Gll^Fp, Gll^Fp, Gll^Fp
Hh^Fp, Hh^Fp, Gg, Hh^Fp, Gg, Gll^Fp, Gg, Gg, Gg, Gg, Gg, Gg, Gg, Gg, Gs, Gs, Gg, Gg, Gg, Gg, Ww, Ch, Ch, Ch, Md, Gs, Rr^Vhc, Rd, Xos, Cud, Cud, Cud, Xos, Gs, Rp, Xu, Xu, Rr, Cud, Cud, Ww^Bsb\, Ww, Gg, Gg, Gg, Gg, Gg, Gg^Efm, Gg^Efm, Gg^Efm, Gg, Gs^Vh, Gll^Fp, Gll^Fp, Gll^Fp, Gll^Fp, Gg, Gg, Gg, Gll^Fp, Gll^Fp, Gll^Fp
Mm, Mm, Mm, Gg, Gg, Gg, Gg, Gg, Gs^Vh, Gg, Gg, Gg, Rb^Gvs, Rb^Gvs, Rb^Gvs, Gs, Gg, Gg, Gg, Gg, Ww, Ww, Ch, Ch, Gs, Rd, Rr, Rd, Gs, Cud, Xos, Cud, Ds, Gs, Rr, Rp^Vhcr, Gd, Xu, Xu, Ww, Gg, Re, Re, Gg, Re, Gg, Gg, Gg, Gs, Gs^Efm, Gs, Gg, Gs, Gg, Gg, Gg, Gg, Gg, Gg, Gll^Fp, Gll^Fp, Gll^Fp
Mm, Mm, Mm, Hh, Gg, Gg, Gg, Gg, Gg, Gg, Rb^Gvs, Rb^Gvs, Rb^Gvs, Rb^Gvs, Rb^Gvs, Rb^Gvs, Rb^Gvs, Gg, Gg, Gg, Gg, Ww, Ww, 5 Kh, Ch, Gs, Rd, Rr^Vhc, Re, Re, Re, Re, Gg, Rr^Vhc, Gs, Gd, Mm, Mm, Ch, Ww, Ww, Gg, Gg, Re, Re, Re, Gg, Gs^Vl, Gg, Gg, Gg, Gg, Gg, Gg, Gg, Gg, Hh, Gg, Gg, Gs^Vc, Gg, Gll^Fp
Mm, Mm, Hh, Hh, Hh, Hh, Gg, Gg, Gg^Efm, Gg, Gg, Rb^Gvs, Rb^Gvs, Rb^Gvs, Rb^Gvs, Rb^Gvs, Rb^Gvs, Rb^Gvs, Gg, Gg, Gg, Ww, Ww, Ch, Ch, Ch, Ms^Xm, Gs, Re, Re, Re, Re, Re, Mm, Mm, Hh, Ch, Ch, Ch, Ww, Ss, Ww, Gg, Re, Re, Re, Re, Gg, Gg, Gg, Gg, Gg, Gg, Hh, Hh, Hh, Hh, Gg, Gg, Gg, Gg, Gg
Mm, Mm, Mm, Hh, Gg, Gg, Rb^Gvs, Gg, Gg, Gg, Gg, Gg, Gg, Rb^Gvs, Rb^Gvs, Rb^Gvs, Gg, Gg, Gg, Gg, Gg, Gg, Ww, Ww, Ch, Ch, Xu, Xu, Cud, Re, Cud, Re, Cud, Xu, Xu, Ch, Ch, 6 Kh, Ch, Ww, Ss, Ww, Ss, Gg, Gg, Gg, Gg, Gg, Gg, Gg, Gg, Gg, Gg, Hh, Hh, Hh, Gg, Gg, Gg, Gg, Gg, Gg
Mm, Mm, Mm, Hh, Rb^Gvs, Rb^Gvs, Rb^Gvs, Rb^Gvs, Rb^Gvs, Gg, Gg, Gg, Rb^Gvs, Gg, Gs^Vh, Gg, Gg, Gg, Gg, Gg, Gg, Re, Ww, Ww, Ww, Xu, Cud, Rr, Rr, Cud, Xu, Cud, Rr, Rr, Cud, Xu, Ww, Ch, Ch, Ch, Ss, Ww, Ww, Ss, Ss, Gg, Gg, Gg, Gg, Gg^Efm, Gd, Gg, Gg, Gg, Gg, Gg, Gg, Gg, Gg, Gg, Gll^Fp, Gll^Fp
Hh, Mm, Gg, Gg, Gg, Rb^Gvs, Rb^Gvs, Rb^Gvs, Gg, Gg, Rb^Gvs, Rb^Gvs, Rb^Gvs, Rb^Gvs, Rb^Gvs, Gg, Gg, Gg, Gg, Gg, Gg, Wo, Gg, Gg, Gg, Ww, Ww^Bsb/, Cud, Cud, Rr, Xu, Rr, Cud, Cud, Ww^Bsb\, Ww, Ww, Ch, Ch, Ch, Ss, Ss, Wo, Ss, Ss, Gll^Fp, Gg, Gg, Gd, Gd, Gd, Gd, Gg, Gg, Gs^Vl, Gg, Gg, Gg, Gg, Gg, Gll^Fp, Gll^Fp
Hh, Hh, Gg, Gg, Gs^Vh, Gg, Gg, Gg, Gll^Fp, Gll^Fp, Gg, Rb^Gvs, Rb^Gvs, Rb^Gvs, Gg, Gg, Gg, Gg, Ww, Ww, Wo, Wo, Gg, Gg, Re, Re, Gg, Ww, Ww, Xu, Ww, Xu, Ww, Ww, Gg, Re, Gg, Ww, Ww, Ss, Ss, Ss, Wo, Ss, Ss, Ss, Gg, Gd, Gg, Gg, Gg, Gd, Gd, Gd, Gg, Gg, Gg, Gg, Gg, Gll^Fp, Gll^Fp, Gll^Fp
Gg, Gg, Gg, Gg, Gg, Gg, Gg, Gg, Gg, Hh, Hh, Gg, Gg, Gg^Efm, Gg, Gg, Gg, Gg, Ww, Ww, Ww, Ww, Re, Re, Gg, Gg, Gg, Gg, Gg, Ww, Gg, Ww, Gg, Gg, Gg, Re, Gg, Ww, Ww, Ss, Wo, Wo, Ss, Ss, Ss, Gll^Fp, Gll^Fp, Gll^Fp, Gll^Fp, Gg, Gd, Gg, Gg, Gg, Gg, Gg, Gg, Gg, Gg, Gg, Gg, Gll^Fp
Gg, Gg, Gg, Gg, Gg, Gg^Efm, Gg, Gg, Gg, Hh^Vhh, Hh, Gg, Gg, Gg, Ww, Gg, Ww, Ww, Wo, Ww, Ww, Gg, Re, Gg, Gs, Gs, Gg, Gg, Gg, Gg, Gg, Gg, Gg, Gg, Gg, Re, Gg, Ss, Ss, Ww, Ss, Ss, Ss, Ss, Gg, Gg, Gg, Gll^Fp, Gg, Gg, Gg, Gd, Gg, Gg, Gll^Fp, Gll^Fp, Gs^Vh, Gg, Gg^Efm, Gg, Gg, Gg
Gll^Fp, Gg, Gll^Fp, Gll^Fp, Gg, Gg, Gg, Gg, Hh, Hh, Ms, Gg, Ms, Ms, Ms, Ww, Ww, Wo, Ww, Ww, Gg, Gg, Re, Gd^Vo, Gd, Gs, Gg, Gg, Gg, Gg, Re, Gg, Re, Gg, Re, Re, Re, Ss, Gg, Ss, Gll^Fp, Gll^Fp, Gll^Fp, Gll^Fp, Gll^Fp, Gg, Gg, Gg, Gd^Vo, Gg, Gg, Gg, Gg, Gll^Fp, Gll^Fp, Gll^Fp, Gll^Fp, Gg, Gg, Gg, Gg, Gg
Gll^Fp, Gll^Fp, Gll^Fp, Gll^Fp, Gs^Vl, Gg, Md, Gg, Md, Mm, Ms, Ms, Ms, Ms, Ms, Ww, Wo, Wo, Gg, Gg, Gg, Gg, Re, Re, Re, Re, Re, Re, Re, Re, Gg, Re, Gg, Re, Gll^Fp, Gg, Gg, Re, Gg, Gg, Gll^Fp, Gll^Fp, Gg^Fet, Gll^Fp, Gg, Gg, Gg, Gg, Gg, Gg, Gg, Gg, Gll^Fp, Gll^Fp, Gll^Fp, Gll^Fp, Gll^Fp, Gg, Gg, Gg, Gg, Gg
Mm, Gll^Fp, Gll^Fp, Gg, Md, Ms, Ms, Md, Ms, Ms, Ms, Ms, Mm, Md, Wo, Wo, Wo, Wo, Gg, Gg, Re, Re, Gg, Gg, Gll^Fp, Gll^Fp, Gll^Fp, Gg, Gll^Fp, Gg, Gg, Gg, Gg, Gll^Fp, Gll^Fp, Gll^Fp, Gll^Fp, Hh, Hh, Gg, Gg, Gll^Fp, Gg, Gg, Gg, Gg, Gd, Gd, Gd, Gg, Gg, Gg, Gll^Fp, Gg, Gll^Fp, Gll^Fp, Gg, Gg, Gg^Efm, Gg, Gg, Gg
Mm, Mm, Md, Ms, Ms, Ms, Ms, Ms, Ms, Ms, Mm, Mm, Gg, Gg, Wo, Wo, Wo, Wo, Gg, Gg, Re, Re, Gg, Gg^Fet, Gll^Fp, Gll^Fp, Gll^Fp, Gll^Fp, Gll^Fp, Gll^Fp, Gg, Gg, Gs^Vh, Gg, Gg, Gll^Fp, Gg, Hh^Fp, Hh, Hh^Vhh, Gg, Gg, Gg, Gg, Gg, Gg, Gd, Gg, Gd, Gd, Gg, Gg, Gg, Gg, Gg, Gg, Gg, Gg, Gg, Gg, Gg, Gg
Mm, Mm, Ms, Ms, Ms, Ms, Md, Ms, Ms, Mm, Mm, Gg, Gg, Gll^Fp, Gll^Fp, Wo, Wo, Ww, Ww, Gg, Re, Gg, Gg, Gll^Fp, Gll^Fp, Gll^Fp, Hh, Gll^Fp, Hh, Hh, Gg, Gg, Gs, Gs, Gg, Gg, Gll^Fp, Hh^Fp, Gg, Gg, Gg, Gg, Gs, Gs, Gs, Gg, Gs, Gd, Gg, Gd, Gg^Efm, Gg, Gg, Gg, Gg, Gg, Gg, Gg, Gg, Gg, Gg, Gg
Mm, Mm, Mm, Hh^Fp, Hh^Fp, Hh, Hh, Hh, Gg, Ms, Mm, Mm, Mm, Gll^Fp, Gll^Fp, Gg, Wo, Wo, Ww, Gg, Re, Gg, Gd, Gg, Gg, Hh, Hh, Hh^Fp, Hh, Hh, Gs, Gs, Gs, Gs, Gg, Gg, Hh, Gll^Fp, Gll^Fp, Gg, Gg, Gg, Gg, Gs, Gs, Gs, Hh, Gg, Gg, Gg, Gg, Gg, Gg, Gg, Gg, Gg, Gg, Gg, Gg, Gg, Gg, Gg
Hh, Mm, Gll^Fp, Hh^Fp, Gll^Fp, Gg, Gg, Hh, Gg, Gg, Gg, Gs^Vc, Gg, Gll^Fp, Gg, Gg, Wo, Wo, Wo, Gg, Re, Gd^Vo, Gd, Gd, Gg, Gg, Gg, Gg, Gg, Gg, Gg, Gs, Gs, Gg, Gg, Hh, Hh, Gll^Fp, Gll^Fp, Gll^Fp, Gs^Vl, Gg^Efm, Gs, Gs, Gs, Gs, Hh, Md, Gll^Fp, Gll^Fp, Gll^Fp, Gll^Fp, Gll^Fp, Gg, Gg, Gg, Gg, Gs^Vl, Gg, Gg, Gg, Gg
Hh, Hh, Hh^Vhh, Gll^Fp, Gg, Gg, Gg, Gg, Gg, Gg, Gg, Gg, Gg, Gg, Gg, Ww, Wo, Wo, Wo, Gd, Re, Gd, Gg, Gg, Gg, Gg, Gll^Fp, Gg, Gll^Fp, Gg, Gg, Gg, Gll^Fp, Gll^Fp, Gll^Fp, Hh, Hh, Gll^Fp, Gll^Fp, Gll^Fp, Gg, Gg, Gg, Gg, Gs, Hh, Hh, Hh^Fp, Hh, Gll^Fp, Gll^Fp, Gll^Fp, Gll^Fp, Gll^Fp, Gg, Gg, Gg, Gg, Gg, Gg, Gll^Fp, Gll^Fp
Hh, Hh, Hh, Gg, Gg, Gg, Mm, Gg, Gg, Gg, Gg, Gg, Gg, Gg, Gg, Ww, Wo, Wo, Gg, Gg, Re, Gd, Gll^Fp, Gll^Fp, Gll^Fp, Gll^Fp, Hh, Gll^Fp, Hh, Hh, Rd, Gg, Gs, Gd^Vo, Gll^Fp, Gg, Gg, Gll^Fp, Gg, Gg, Gg, Gll^Fp, Gll^Fp, Gg, Gg, Gg, Gg, Gg, Gs^Vh, Gll^Fp, Gll^Fp, Gll^Fp, Gll^Fp, Gll^Fp, Gg, Gg, Gg, Gg, Gll^Fp, Gll^Fp, Gll^Fp, Gll^Fp
Hh, Hh, Mm, Mm, Mm, Mm, Gg, Gg, Gg^Efm, Gg^Efm, Gg, Gg, Gg, Gg, Gg, Ww, Wo, Wo, Gg, Gg, Re, Gg, Gg, Gll^Fp, Gg, Hh, Hh, Hh^Fp, Re, Rd, Rb, Gg, Gd, Gg, Gg, Gll^Fp, Gg, Gg, Gg, Gg, Gg, Gll^Fp, Gg, Gg, Gg, Gg, Gg, Gg, Gg, Gll^Fp, Gll^Fp, Gll^Fp, Gll^Fp, Gll^Fp, Gg, Gg, Gg, Gg, Gll^Fp, Gll^Fp, Gll^Fp, Gll^Fp
Ms, Mm, Mm, Mm, Mm, Mm, Gll^Fp, Gg, Gg, Gg^Efm, Gg, Gs^Vc, Gg, Gg, Gg, Ww, Ww, Ww, Gg, Gg, Re, Gg, Gll^Fp, Gll^Fp, Gg, Hh, Re, Rd, Rd, Rb, Rb, Rb, Gd, Re, Rd, Rd, Rd, Rd, Rd, Gg, Gg, Gg, Gg, Gg, Gg, Gg, Gg, Gg, Gg, Gll^Fp, Gll^Fp, Gll^Fp, Gll^Fp, Gg, Gg, Gg, Gg, Gll^Fp, Gg, Gll^Fp, Gg, Gg
Ms, Ms, Ms, Mm, Mm, Gll^Fp, Mm, Gg, Gg, Gg, Gg, Gg, Gg, Gg, Gg, Gg, Ww, Ww, Gg, Gg, Re, Gg, Gg, Gll^Fp, Gg, Re, Re, Rd, Ce, Re, Re, Rb, Ce, Re, Re, Rd, Rd, Rd, Gg, Gll^Fp, Gll^Fp, Gg, Gll^Fp, Gg, Gg, Gg, Gg, Gg, Gll^Fp, Gll^Fp, Gll^Fp, Gll^Fp, Rb^Gvs, Rb^Gvs, Rb^Gvs, Gg, Gg, Gg, Gg, Gg, Gg, Gg
Mm, Ms, Ms, Ms, Ms, Mm, Mm, Mm, Gg, Gg, Gg, Gg, Ww, Gg, Gg, Gg, Ww, Ww, Gg, Gg, Re, Gg, Gg, Gg, Re, Re, Re, Rd, Ce, Ce, Ce, Ce, Ce, Re, Re, Rd^Vu, Rd, Rd, Gg, Gll^Fp, Gll^Fp, Gll^Fp, Gg, Gg, Gg, Gg, Gg, Gg, Gg, Gll^Fp, Rb^Gvs, Rb^Gvs, Rb^Gvs, Rb^Gvs, Rb^Gvs, Rb^Gvs, Gg, Gg, Gg, Gg, Gg, Gg
Gll^Fp, Mm, Hh, Ms, Ms, Ms, Gg, Mm, Wwf, Wwf, Ww, Ww, Ww, Ww, Ww, Ww, Ww, Ww, Re, Re, Gg, Gg, Gll^Fp, Gll^Fp, Re, Re^Vu, Re, Re, Re, Ce, 1 Ke, Ce, Re, Re, Re, Rd, Rd, Rd, Gll^Fp, Gll^Fp, Gll^Fp, Gg, Gg, Gg^Efm, Gg, Gg, Gg, Gg, Gg, Gg, Gg^Efm, Rb^Gvs, Rb^Gvs, Rb^Gvs, Gg, Gg, Gll^Fp, Gg, Gll^Fp, Gg, Gg, Gg
Gll^Fp, Gll^Fp, Gll^Fp, Hh, Hh, Ms, Gg, Gg, Wwf, Wwf, Wwf, Ww, Gg, Ww, Ww, Ww, Re, Re, Gg, Gg, Gll^Fp, Gll^Fp, Gll^Fp, Gll^Fp, Rd, Re, Re, Re, Re, Ce, Ce, Ce, Re, Re, Rb, Rb, Gll^Fp, Gll^Fp, Gll^Fp, Gll^Fp, Gg, Gg, Gg, Gg, Gd^Vo, Gg, Gg, Gg, Gg, Gg, Gg^Efm, Gg, Gg, Gg, Gll^Fp, Gll^Fp, Gll^Fp, Gll^Fp, Gg, Gg, Gg, Gg
Mm, Gll^Fp, Gll^Fp, Hh^Fp, Hh, Hh, Ww, Wwf, Wwf, Wwf, Gll^Fp, Gll^Fp, Re, Gg, Re, Re, Gs^Vh, Gg, Gg, Gg, Gll^Fp, Gll^Fp, Gll^Fp, Gll^Fp, Gll^Fp, Rd, Rd^Vu, Re, Re, Re, Re, Re, Re, Rb^Vu, Rb, Gg, Gll^Fp, Gll^Fp, Gll^Fp, Gg, Gg, Gg, Gg, Gg, Gg, Gg, Rb^Gvs, Gg, Gg, Gg, Gg, Gs^Vl, Gll^Fp, Gll^Fp, Gll^Fp, Gll^Fp, Gll^Fp, Gll^Fp, Gg, Gd^Vo, Gg, Gg
Mm, Mm, Mm, Hh^Vhh, Ww, Ww, Ww, Wwf, Gll^Fp, Gll^Fp, Gg^Fet, Gll^Fp, Gg, Re, Gg, Gg, Gg, Gg, Gg, Gll^Fp, Gll^Fp, Gll^Fp, Gg, Gll^Fp, Gg, Rd, Rd, Re, Rb^Vu, Rb, Gd, Re^Vu, Re, Rb, Gs, Gg, Gg, Gll^Fp, Hh^Fp, Gg, Gg, Gg, Gg^Efm, Gg, Rb^Gvs, Rb^Gvs, Rb^Gvs, Rb^Gvs, Rb^Gvs, Gg, Gll^Fp, Gll^Fp, Gll^Fp, Hh, Mm, Mm, Hh^Fp, Gll^Fp, Gg, Gg, Gg, Gg
Mm, Mm, Mm, Hh, Ww, Ww, Hh, Hh, Gll^Fp, Gll^Fp, Mm, Mm, Mm, Gg, Gll^Fp, Gg, Gg, Gg, Gg, Gll^Fp, Gg, Gg, Gg, Gg, Gg, Gg, Gg, Rb, Rb, Gd, Gg, Rb, Gs, Gs, Gg, Gg, Hh, Hh^Fp, Hh, Gg, Gg, Gg, Rb^Gvs, Rb^Gvs, Rb^Gvs, Rb^Gvs, Rb^Gvs, Rb^Gvs, Gg, Gll^Fp, Gg, Gll^Fp, Gll^Fp, Hh, Hhd, Hh^Fp, Gll^Fp, Gll^Fp, Gg, Gg, Gg, Gg
Hh, Mm, Ww, Ww, Ww, Ww, Mm, Mm, Mm, Mm, Mm, Mm, Hh, Mm, Gll^Fp, Gll^Fp, Gg, Gg, Gg, Gg, Gs^Vh, Gg, Gg, Gg, Gll^Fp, Gll^Fp, Gg, Gg, Gg, Gg, Gll^Fp, Gg, Gll^Fp, Gg, Gll^Fp, Hh, Hh, Hh, Hh^Vhh, Gg, Gg, Gg, Gg, Rb^Gvs, Rb^Gvs, Rb^Gvs, Rb^Gvs, Rb^Gvs, Rb^Gvs, Gg, Gg, Gg, Gg, Gll^Fp, Gg, Hhd^Vhhr, Gg, Gg, Gg, Gg, Gg, Gg
Ww, Ww, Ww, Ww, Hh, Mm, Mm, Mm, Mm, Mm, Hh, Hh, Gg, Gg, Gg, Gg, Gg, Gg, Gg, Gg, Gg, Gg, Gg, Gg, Gg, Gll^Fp, Gg, Gg, Gll^Fp, Gll^Fp, Gll^Fp, Gll^Fp, Gll^Fp, Gll^Fp, Gll^Fp, Gll^Fp, Hh, Hh, Hh, Hh, Gg, Gg, Gg, Gg, Gg, Rb^Gvs, Rb^Gvs, Rb^Gvs, Gg, Gg, Gg, Gg, Gg, Gg, Gg, Gg, Gg, Gg, Gg, Gg, Gg, Gg
Wwt, Ww, Wwt, Hh, Hh, Mm, Mm, Mm, Mm, Hh, Gll^Fp, Hh, Hh, Gg, Gg, Gg, Gg, Gg, Gg, Gg, Gg, Gg, Gg, Gg, Gg, Gll^Fp, Gll^Fp, Gll^Fp, Gll^Fp, Gll^Fp, Gll^Fp, Gll^Fp, Gg, Gll^Fp, Gg, Hh, Hh, Hh, Hh, Hh, Hh, Gg, Gg, Gg, Gg, Gg, Gg, Gg, Gg, Gg, Gg, Gg, Gg, Gg, Gg, Gg, Gg, Gg, Gg, Gg, Gg, Gg
