border_size=1
usage=map

Gg, Gg, Gg, Gg^Efm, Gg, Gg, Gg, Gg, Gs^Fp, Gs^Fp, Gs^Fp, Gg, Gs^Fp, Gg^Efm, Re, Re, Re, Re, Re, Gg, Gg, Gs^Fp, Gs^Fp, Gs^Fp, Gg, Gg, Gg, Gg, Gg, Gg, Gg, Gg, Gg, Gg, Gg, Gg
Gg, Gg, Gg, Gg^Efm, Gg, Gg, Gg, Gg, Gs^Fp, Gs^Fp, Gs^Fp, Gg, Gs^Fp, Gg^Efm, Re, Re, Re, Re, Re, Gg, Gg, Gs^Fp, Gs^Fp, Gs^Fp, Gg, Gg, Gg, Gg, Gg, Gg, Gg, Gg, Gg, Gg, Gg, Gg
Gg, Gg, Gg^Efm, Gg, Gg, Gg^Efm, Gs^Fp, Gs^Fp, Gs^Fp, Gg^Fet, Gs^Fp, Gs^Fp, Gs^Fp, Gs^Fp, Ch, Ch, Re, Ch, Ch, Re, Gs^Fp, Gs^Fp, Gg^Fet, Gs^Fp, Gs^Fp, Gs^Fp, Gs^Fp, Gs^Fp, Gs^Fp, Gg, Gs^Fp, Gg, Gg, Gg, Gg, Gg
Gg, Gg, Gg^Efm, Gg, Gs^Fp, Gg, Gs^Fp, Gs^Fp, Gg^Fet, Gs^Fp, Gs^Fp, Gg^Ve, Hh, Hh, Ch, Kh, Re, Kh, Ch, Re, Hh, Gs^Fp, Hh, Gs^Fp, Gg^Fet, Gs^Fp, Gs^Fp, Gs^Fp, Gs^Fp, Gs^Fp, Gs^Fp, Gs^Fp, Gg, Gg, Gg, Gg
Gg^Efm, Gg^Efm, Gg, Gg, Gs^Fp, Gs^Fp, Gs^Fp, Gg^Fet, Gs^Fp, Gs^Fp, Hh, Hh, Mm, Hh, Mm, Mm, Re, Mm, Mm, Hh, Mm, Hh, Hh, Hh, Gs^Fp, Gs^Fp, Gs^Fp, Gg^Fet, Gs^Fp, Gs^Fp, Gs^Fp, Gs^Fp, Gs^Fp, Gg, Gg, Gg
Gg^Efm, Gg^Efm, Gg, Gg, Gs^Fp, Gs^Fp, Gg^Ve, Gs^Fp, Hh, Mm, Mm, Mm, Mm, Mm, Mm, Mm, Re, Mm, Mm, Mm, Mm, Mm, Hh, Hh, Gg^Ve, Hh, Hh, Gs^Fp, Gs^Fp, Gg^Ve, Gs^Fp, Gs^Fp, Gs^Fp, Gg, Gg, Gg
Gg^Efm, Gg^Efm, Gg, Gs^Fp, Gs^Fp, Gs^Fp, Hh, Hh, Mm, Mm, Ch, Ch, Ch, Ch, Ch, Mm, Re, Mm, Ch, Ch, Ch, Ch, Ch, Hh, Mm, Hh, Hh, Hh, Gg^Fet, Gs^Fp, Gs^Fp, Gs^Fp, Gg, Gg, Gg, Gg
Gg^Efm, Gg^Efm, Gg, Gs^Fp, Gg, Gs^Fp, Hh, Mm, Mm, Mm, Ch, Ch, Kh, Ch, Ch, Kh, Re, Kh, Ch, Ch, Kh, Ch, Ch, Mm, Mm, Mm, Hh, Hh, Gs^Fp, Gs^Fp, Gg, Gg, Gg, Gg, Gg, Gg
Gg^Efm, Gg^Efm, Gg^Efm, Gg, Gg, Hh, Hh, Hh, Mm, Mm, Ch, Kh, Gg^Vh, Ch, Re, Re, Re, Re, Re, Ch, Gg^Vh, Kh, Ch, Mm, Mm, Mm, Mm, Hh, Hh, Gg, Gg, Gg^Efm, Gg, Gg, Gg, Gg
Gg^Efm, Gg^Efm, Gg, Gg, Ch, Ch, Mm, Mm, Mm, Mm, Kh, Ch, Re, Re, Ch, Gg^Vh, Ch, Gg^Vh, Ch, Re, Re, Ch, Kh, Mm, Mm, Mm, Mm, Hh, Hh, Ch, Ch, Gg, Gg, Gg, Gg, Gg
Gg^Efm, Gg^Efm, Gg^Efm, Re, Re, Kh, Re, Mm, Re, Mm, Re, Ch, Re, Gg^Vh, Ch, Ch, 8 Kh, Ch, Ch, Gg^Vh, Re, Ch, Re, Mm, Re, Mm, Re, Hh, Re, Kh, Re, Gg, Gg, Gg, Gg, Gg
Gg, Gg, Gg^Efm, Re, Re, Re, Re, Re, Re, Re, Re, Re, Re, Gg^Vh, Ch, 9 Kh, 1 Kh, 7 Kh, Ch, Gg^Vh, Re, Re, Re, Re, Re, Re, Re, Re, Re, Re, Re, Gg, Gg, Gg, Gg, Gg
Gg, Gg, Gg^Efm, Re, Ch, Kh, Mm, Mm, Mm, Mm, Kh, Ch, Re, Gg^Vh, Ch, Ch, Ch, Ch, Ch, Gg^Vh, Re, Ch, Kh, Re, Re, Mm, Mm, Mm, Hh, Kh, Ch, Gg, Gg, Gg, Gg, Gg
Gg^Efm, Gg^Efm, Gg, Hh, Hh, Ch, Mm, Mm, Mm, Gg, Ch, Ch, Gg^Vh, Re, Re, Gg^Vh, Re, Gg^Vh, Re, Re, Gg^Vh, Ch, Ch, Re, Mm, Mm, Mm, Mm, Hh, Ch, Gg, Gg, Gg, Gg, Gg, Gg
Gg, Gg, Gs^Fp, Hh, Hh, Hh, Hh, Mm, Mm, Mm, Ch, Kh, Kh, Ch, Ch, Re, Re, Re, Ch, Ch, Kh, Kh, Ch, Mm, Mm, Mm, Mm, Hh, Hh, Gg, Gs^Fp, Gg, Gg, Gg, Gg, Gg
Gs^Fp, Gs^Fp, Gs^Fp, Gs^Fp, Gs^Fp, Hh, Mm, Mm, Mm, Mm, Ch, Ch, Ch, Ch, Ch, Kh, Re, Kh, Ch, Ch, Ch, Ch, Ch, Mm, Mm, Mm, Mm, Hh, Hh, Gs^Fp, Gs^Fp, Gs^Fp, Gs^Fp, Gg, Gg, Gg
Gs^Fp, Gs^Fp, Gg^Fet, Gg^Fet, Hh, Hh, Mm, Mm, Mm, Mm, Mm, Ch, Mm, Ch, Mm, Re, Re, Re, Mm, Ch, Mm, Ch, Mm, Mm, Mm, Mm, Hh, Hh, Hh, Hh, Gs^Fp, Gg^Fet, Gs^Fp, Gs^Fp, Gg, Gg
Gg, Gg, Gs^Fp, Gs^Fp, Gg^Ve, Hh, Hh, Mm, Hh, Mm, Mm, Mm, Mm, Mm, Mm, Mm, Re, Mm, Mm, Mm, Mm, Mm, Mm, Mm, Hh, Hh, Hh, Hh, Gs^Fp, Gg^Ve, Gs^Fp, Gs^Fp, Gs^Fp, Gs^Fp, Gs^Fp, Gs^Fp
Gs^Fp, Gs^Fp, Gs^Fp, Gg^Fet, Gs^Fp, Hh, Hh, Hh, Hh, Hh, Hh, Mm, Mm, Mm, Ch, Mm, Re, Mm, Ch, Mm, Mm, Mm, Hh, Mm, Hh, Hh, Gs^Fp, Hh, Gs^Fp, Gs^Fp, Gg^Fet, Gs^Fp, Gg, Gs^Fp, Gs^Fp, Gs^Fp
Gg, Gg, Gg, Gs^Fp, Gs^Fp, Gs^Fp, Gs^Fp, Gs^Fp, Gs^Fp, Hh, Gs^Fp, Hh, Hh, Mm, Ch, Kh, Re, Kh, Ch, Hh, Hh, Hh, Hh, Hh, Gs^Fp, Gs^Fp, Gs^Fp, Gs^Fp, Gs^Fp, Gs^Fp, Gs^Fp, Gg, Gg, Gg, Gg, Gg
Gg, Gg, Gs^Fp, Gs^Fp, Gg, Gs^Fp, Gs^Fp, Gs^Fp, Gs^Fp, Gs^Fp, Gs^Fp, Gs^Fp, Gs^Fp, Hh, Re, Ch, Re, Ch, Re, Hh, Gg, Hh, Hh, Hh, Gg^Ve, Gs^Fp, Gs^Fp, Gs^Fp, Gs^Fp, Gs^Fp, Gs^Fp, Gg, Gg, Gg, Gg, Gg
Gg, Gg, Gg, Gg, Gg, Gg, Gg, Gs^Fp, Gs^Fp, Gs^Fp, Gs^Fp, Gs^Fp, Gs^Fp, Gs^Fp, Gs^Fp, Re, Gg, Re, Gg, Gg, Gg, Gs^Fp, Gs^Fp, Hh, Gs^Fp, Gs^Fp, Gs^Fp, Gs^Fp, Gs^Fp, Gs^Fp, Gg, Gg, Gg, Gg, Gg, Gg
Gg, Gg, Gg, Gg, Gg, Gg, Gg, Gs^Fp, Gg, Gs^Fp, Gs^Fp, Gg, Gg, Gg, Gg, Gg, Gg, Gg, Gg, Gg, Gg, Gg, Gs^Fp, Gs^Fp, Gs^Fp, Gs^Fp, Gs^Fp, Gg, Gg, Gg, Gg, Gg, Gg, Gg, Gg, Gg
Gg, Gg, Gg, Gg, Gg, Gg, Gg, Gs^Fp, Gg, Gs^Fp, Gs^Fp, Gg, Gg, Gg, Gg, Gg, Gg, Gg, Gg, Gg, Gg, Gg, Gs^Fp, Gs^Fp, Gs^Fp, Gs^Fp, Gs^Fp, Gg, Gg, Gg, Gg, Gg, Gg, Gg, Gg, Gg
