border_size=1
usage=map

Xuc, Xuc, Xuc, Xuc, Xuc, Xuc, Xuc, Rr, Rr, Rr, Xuc, Xuc, Xuc, Xuc, Xuc, Xuc
Xuc, Xuc, Xuc, Xuc, Xu, Xuc, Xuc, Rr, Rr, Rr, Xuc, Xuc, Xu, Xuc, Xuc, Xuc
Xuc, Xuc, Xuc, Xuc, Xu, Xu, Xu, Rr, Xu, Rr, Xu, Xu, Xu, Xuc, Xuc, Xuc
Xuc, Xuc, Xuc, Xuc, Cud, Cud, Cud, Cud, 2 Kud, Cud, Cud, Cud, Cud, Xuc, Xuc, Xuc
Xuc, Xuc, Xuc, Xuc, Rr, Cud, Re, Cud, Cud, Cud, Rr, Cud, Rr, Xuc, Xuc, Xuc
Xuc, Xuc, Xuc, Xuc, Rr, Rr, Rr, Rr, Rr, Rr, Rr, Rr, Rr, Xuc, Xuc, Xuc
Xuc, Xuc, Xuc, Xuc, Rr, Rr, Rr, Rr, Rr, Rr, Rr, Rr, Rr, Xuc, Xuc, Xuc
Xuc, Xuc, Xuc, Cud, Rr, Rr, Ur, Rr, Cud, Rr, Rr, Rr, Rr, Cud, Xuc, Xuc
Xuc, Xuc, Rr, Rr, Rr, Ur, Xuc, Cud, 1 Kud, Cud, Xuc, Rr, Rr, Rr, Rr, Xuc
Rr, Rr, Rr, Cud, Xuc, Xuc, Xuc, Xuc, Xuc, Xuc, Xuc, Xuc, Xuc, Cud, Ur, Ur
Rr, Uu^Uf, Xuc, Xuc, Xuc, Xuc, Xuc, Xuc, Xuc, Xuc, Xuc, Xuc, Xuc, Xuc, Xuc, Ur
Xuc, Xuc, Xuc, Xuc, Xuc, Xuc, Xuc, Xuc, Xuc, Xuc, Xuc, Xuc, Xuc, Xuc, Xuc, Xuc
