border_size=1
usage=map

Xu, Xu, Xu, Xu, Xu, Xu, Xu, Xu, Xu, Rr, Rr, Rr, Xu, Xu, Xu, Xu, Xu, Xu, Xu, Xu, Xu, Xu
Rr, Xu, Xu, Xu, Xu, Xu, Xu, Xu, Xu, Rr, Rr, Rr, Xu, Xu, Xu, Xu, Xu, Xu, Xu, Xu, Rr, Rr
Rr, Rr, Rr, Xu, Xu, Xu, Xu, Xu, Xu, Rr, Cud, Rr, Xu, Xu, Xu, Xu, Xu, Xu, Rr, Rr, Rr, Rr
Rr, Xu, Rr, Rr, Rr, Xu, Rr, Xu, Xu, Cud, 2 Kud, Cud, Xu, Xu, Rr, Xuc, Rr, Rr, Rr, Xu, Rr, Rr
Xu, Rr, Rr, Rr, Rr, Cud, Rr, Rr, Cud, Cud, Cud, Cud, Cud, Rr, Rr, Cud, Rr, Rr, Rr, Rr, Xu, Xu
Xu, Xu, Rr, Rr, Rr, Xu, Rr, Rr, Rr, Rr, Rr, Rr, Rr, Rr, Rr, Xu, Rr, Rr, Rr, Xu, Xu, Xu
Xu, Xu, Rr, Rr, Rr, Cud, Rr, Rr, Rr, Rr, Rr, Rr, Rr, Rr, Rr, Cud, Rr, Rr, Rr, Xu, Xu, Xu
Xu, Xu, Rr, Rr, Rr, Xu, Rr, Rr, Rr, Rr, Rr, Rr, Rr, Rr, Rr, Xu, Rr, Rr, Rr, Xu, Xu, Xu
Xu, Xu, Rr, Rr, Rr, Cud, Rr, Rr, Rr, Rr, Rr, Rr, Rr, Rr, Rr, Cud, Rr, Rr, Rr, Xu, Xu, Xu
Xu, Xu, Rr, Rr, Rr, Xu, Rr, Rr, Rr, Rr, Rr, Rr, Rr, Rr, Rr, Xu, Rr, Rr, Rr, Xu, Xu, Xu
Rr, Rr, Rr, Rr, Rr, Cud, Rr, Rr, Rr, Rr, 1 Rr, Rr, Rr, Rr, Rr, Cud, Rr, Rr, Rr, Rr, Rr, Xu
Rr, Xu, Rr, Rr, Xu, Xu, Xu, Xu, Cud, Rr, Rr, Rr, Cud, Xu, Xu, Xu, Xu, Rr, Rr, Xu, Rr, Rr
Rr, Rr, Xu, Xu, Xu, Xu, Xu, Xu, Rr, Xu, Cud, Xu, Rr, Xu, Xu, Xu, Xu, Xu, Xu, Rr, Rr, Rr
Xu, Xu, Xu, Xu, Xu, Xu, Xu, Xu, Rr, Rr, Xu, Rr, Rr, Xu, Xu, Xu, Xu, Xu, Xu, Xu, Xu, Rr
Xu, Xu, Xu, Xu, Xu, Xu, Xu, Xu, Rr, Rr, Rr, Rr, Rr, Xu, Xu, Xu, Xu, Xu, Xu, Xu, Xu, Xu
Xu, Xu, Xu, Xu, Xu, Xu, Xu, Xu, Rr, Rr, Xu, Rr, Rr, Xu, Xu, Xu, Xu, Xu, Xu, Xu, Xu, Xu
